testkevin0	Unassigned;Other
testkevin1	k__Archaea;Other
testkevin2	k__Archaea;p__Crenarchaeota
testkevin3	k__Archaea;p__Euryarchaeota
testkevin4	k__Bacteria;Other
testkevin5	k__Bacteria;p__Acidobacteria
testkevin6	k__Bacteria;p__Actinobacteria
testkevin7	k__Bacteria;p__Bacteroidetes
testkevin8	k__Bacteria;p__Chloroflexi
testkevin9	k__Bacteria;p__Cyanobacteria
testkevin10	k__Bacteria;p__Firmicutes
testkevin11	k__Bacteria;p__Fusobacteria
testkevin12	k__Bacteria;p__GN02
testkevin13	k__Bacteria;p__Gemmatimonadetes
testkevin14	k__Bacteria;p__Lentisphaerae
testkevin15	k__Bacteria;p__OP1
testkevin16	k__Bacteria;p__OP8
testkevin17	k__Bacteria;p__Planctomycetes
testkevin18	k__Bacteria;p__Proteobacteria
testkevin19	k__Bacteria;p__SAR406
testkevin20	k__Bacteria;p__SR1
testkevin21	k__Bacteria;p__Synergistetes
testkevin22	k__Bacteria;p__TM7
testkevin23	k__Bacteria;p__Tenericutes
testkevin24	k__Bacteria;p__Verrucomicrobia
testkevin25	k__Bacteria;p__WS3
testkevin26	k__Bacteria;p__[Thermi]
testkevin27	Unassigned;Other;Other
testkevin28	k__Archaea;Other;Other
testkevin29	k__Archaea;p__Crenarchaeota;Other
testkevin30	k__Archaea;p__Crenarchaeota;c__MBGA
testkevin31	k__Archaea;p__Crenarchaeota;c__MCG
testkevin32	k__Archaea;p__Crenarchaeota;c__Thaumarchaeota
testkevin33	k__Archaea;p__Crenarchaeota;c__Thermoprotei
testkevin34	k__Archaea;p__Euryarchaeota;Other
testkevin35	k__Archaea;p__Euryarchaeota;c__ANME-1
testkevin36	k__Archaea;p__Euryarchaeota;c__DSEG
testkevin37	k__Archaea;p__Euryarchaeota;c__Halobacteria
testkevin38	k__Archaea;p__Euryarchaeota;c__Methanomicrobia
testkevin39	k__Archaea;p__Euryarchaeota;c__Thermoplasmata
testkevin40	k__Bacteria;Other;Other
testkevin41	k__Bacteria;p__Acidobacteria;c__Acidobacteria-6
testkevin42	k__Bacteria;p__Actinobacteria;Other
testkevin43	k__Bacteria;p__Actinobacteria;c__Acidimicrobiia
testkevin44	k__Bacteria;p__Actinobacteria;c__Actinobacteria
testkevin45	k__Bacteria;p__Actinobacteria;c__Coriobacteriia
testkevin46	k__Bacteria;p__Actinobacteria;c__OPB41
testkevin47	k__Bacteria;p__Actinobacteria;c__Thermoleophilia
testkevin48	k__Bacteria;p__Bacteroidetes;Other
testkevin49	k__Bacteria;p__Bacteroidetes;c__Bacteroidia
testkevin50	k__Bacteria;p__Bacteroidetes;c__Cytophagia
testkevin51	k__Bacteria;p__Bacteroidetes;c__Flavobacteriia
testkevin52	k__Bacteria;p__Bacteroidetes;c__Sphingobacteriia
testkevin53	k__Bacteria;p__Bacteroidetes;c__[Saprospirae]
testkevin54	k__Bacteria;p__Chloroflexi;Other
testkevin55	k__Bacteria;p__Chloroflexi;c__Anaerolineae
testkevin56	k__Bacteria;p__Chloroflexi;c__Chloroflexi
testkevin57	k__Bacteria;p__Chloroflexi;c__Dehalococcoidetes
testkevin58	k__Bacteria;p__Chloroflexi;c__Ktedonobacteria
testkevin59	k__Bacteria;p__Chloroflexi;c__SAR202
testkevin60	k__Bacteria;p__Cyanobacteria;Other
testkevin61	k__Bacteria;p__Cyanobacteria;c__4C0d-2
testkevin62	k__Bacteria;p__Cyanobacteria;c__Chloroplast
testkevin63	k__Bacteria;p__Cyanobacteria;c__Nostocophycideae
testkevin64	k__Bacteria;p__Cyanobacteria;c__Synechococcophycideae
testkevin65	k__Bacteria;p__Firmicutes;Other
testkevin66	k__Bacteria;p__Firmicutes;c__Bacilli
testkevin67	k__Bacteria;p__Firmicutes;c__Clostridia
testkevin68	k__Bacteria;p__Firmicutes;c__Erysipelotrichi
testkevin69	k__Bacteria;p__Fusobacteria;c__Fusobacteriia
testkevin70	k__Bacteria;p__GN02;c__3BR-5F
testkevin71	k__Bacteria;p__Gemmatimonadetes;c__Gemm-2
testkevin72	k__Bacteria;p__Gemmatimonadetes;c__Gemm-3
testkevin73	k__Bacteria;p__Gemmatimonadetes;c__Gemm-5
testkevin74	k__Bacteria;p__Gemmatimonadetes;c__Gemmatimonadetes
testkevin75	k__Bacteria;p__Lentisphaerae;c__[Lentisphaeria]
testkevin76	k__Bacteria;p__OP1;c__[Acetothermia]
testkevin77	k__Bacteria;p__OP8;c__OP8_2
testkevin78	k__Bacteria;p__Planctomycetes;Other
testkevin79	k__Bacteria;p__Planctomycetes;c__
testkevin80	k__Bacteria;p__Planctomycetes;c__OM190
testkevin81	k__Bacteria;p__Planctomycetes;c__Phycisphaerae
testkevin82	k__Bacteria;p__Proteobacteria;Other
testkevin83	k__Bacteria;p__Proteobacteria;c__Alphaproteobacteria
testkevin84	k__Bacteria;p__Proteobacteria;c__Betaproteobacteria
testkevin85	k__Bacteria;p__Proteobacteria;c__Deltaproteobacteria
testkevin86	k__Bacteria;p__Proteobacteria;c__Epsilonproteobacteria
testkevin87	k__Bacteria;p__Proteobacteria;c__Gammaproteobacteria
testkevin88	k__Bacteria;p__SAR406;c__AB16
testkevin89	k__Bacteria;p__SR1;c__
testkevin90	k__Bacteria;p__Synergistetes;c__Synergistia
testkevin91	k__Bacteria;p__TM7;c__TM7-3
testkevin92	k__Bacteria;p__Tenericutes;c__Mollicutes
testkevin93	k__Bacteria;p__Tenericutes;c__RF3
testkevin94	k__Bacteria;p__Verrucomicrobia;Other
testkevin95	k__Bacteria;p__Verrucomicrobia;c__Opitutae
testkevin96	k__Bacteria;p__Verrucomicrobia;c__Verrucomicrobiae
testkevin97	k__Bacteria;p__WS3;c__PRR-12
testkevin98	k__Bacteria;p__[Thermi];c__Deinococci
testkevin99	Unassigned;Other;Other;Other
testkevin100	k__Archaea;Other;Other;Other
testkevin101	k__Archaea;p__Crenarchaeota;Other;Other
testkevin102	k__Archaea;p__Crenarchaeota;c__MBGA;o__NRP-J
testkevin103	k__Archaea;p__Crenarchaeota;c__MCG;o__pGrfC26
testkevin104	k__Archaea;p__Crenarchaeota;c__Thaumarchaeota;o__Cenarchaeales
testkevin105	k__Archaea;p__Crenarchaeota;c__Thermoprotei;o__Desulfurococcales
testkevin106	k__Archaea;p__Crenarchaeota;c__Thermoprotei;o__Thermoproteales
testkevin107	k__Archaea;p__Euryarchaeota;Other;Other
testkevin108	k__Archaea;p__Euryarchaeota;c__ANME-1;o__
testkevin109	k__Archaea;p__Euryarchaeota;c__DSEG;o__DHVE3
testkevin110	k__Archaea;p__Euryarchaeota;c__Halobacteria;o__Halobacteriales
testkevin111	k__Archaea;p__Euryarchaeota;c__Methanomicrobia;o__Methanomicrobiales
testkevin112	k__Archaea;p__Euryarchaeota;c__Methanomicrobia;o__Methanosarcinales
testkevin113	k__Archaea;p__Euryarchaeota;c__Thermoplasmata;o__Thermoplasmatales
testkevin114	k__Bacteria;Other;Other;Other
testkevin115	k__Bacteria;p__Acidobacteria;c__Acidobacteria-6;Other
testkevin116	k__Bacteria;p__Actinobacteria;Other;Other
testkevin117	k__Bacteria;p__Actinobacteria;c__Acidimicrobiia;o__Acidimicrobiales
testkevin118	k__Bacteria;p__Actinobacteria;c__Actinobacteria;o__Actinomycetales
testkevin119	k__Bacteria;p__Actinobacteria;c__Actinobacteria;o__Bifidobacteriales
testkevin120	k__Bacteria;p__Actinobacteria;c__Coriobacteriia;o__Coriobacteriales
testkevin121	k__Bacteria;p__Actinobacteria;c__OPB41;o__
testkevin122	k__Bacteria;p__Actinobacteria;c__Thermoleophilia;Other
testkevin123	k__Bacteria;p__Actinobacteria;c__Thermoleophilia;o__Solirubrobacterales
testkevin124	k__Bacteria;p__Bacteroidetes;Other;Other
testkevin125	k__Bacteria;p__Bacteroidetes;c__Bacteroidia;o__Bacteroidales
testkevin126	k__Bacteria;p__Bacteroidetes;c__Cytophagia;o__Cytophagales
testkevin127	k__Bacteria;p__Bacteroidetes;c__Flavobacteriia;o__Flavobacteriales
testkevin128	k__Bacteria;p__Bacteroidetes;c__Sphingobacteriia;o__Sphingobacteriales
testkevin129	k__Bacteria;p__Bacteroidetes;c__[Saprospirae];o__[Saprospirales]
testkevin130	k__Bacteria;p__Chloroflexi;Other;Other
testkevin131	k__Bacteria;p__Chloroflexi;c__Anaerolineae;Other
testkevin132	k__Bacteria;p__Chloroflexi;c__Anaerolineae;o__CFB-26
testkevin133	k__Bacteria;p__Chloroflexi;c__Anaerolineae;o__OPB11
testkevin134	k__Bacteria;p__Chloroflexi;c__Anaerolineae;o__S0208
testkevin135	k__Bacteria;p__Chloroflexi;c__Anaerolineae;o__SBR1031
testkevin136	k__Bacteria;p__Chloroflexi;c__Chloroflexi;o__[Roseiflexales]
testkevin137	k__Bacteria;p__Chloroflexi;c__Dehalococcoidetes;o__Dehalococcoidales
testkevin138	k__Bacteria;p__Chloroflexi;c__Ktedonobacteria;o__B12-WMSP1
testkevin139	k__Bacteria;p__Chloroflexi;c__SAR202;o__
testkevin140	k__Bacteria;p__Cyanobacteria;Other;Other
testkevin141	k__Bacteria;p__Cyanobacteria;c__4C0d-2;o__MLE1-12
testkevin142	k__Bacteria;p__Cyanobacteria;c__4C0d-2;o__YS2
testkevin143	k__Bacteria;p__Cyanobacteria;c__Chloroplast;o__Chlorophyta
testkevin144	k__Bacteria;p__Cyanobacteria;c__Chloroplast;o__Streptophyta
testkevin145	k__Bacteria;p__Cyanobacteria;c__Nostocophycideae;o__Nostocales
testkevin146	k__Bacteria;p__Cyanobacteria;c__Synechococcophycideae;o__Pseudanabaenales
testkevin147	k__Bacteria;p__Firmicutes;Other;Other
testkevin148	k__Bacteria;p__Firmicutes;c__Bacilli;Other
testkevin149	k__Bacteria;p__Firmicutes;c__Bacilli;o__Bacillales
testkevin150	k__Bacteria;p__Firmicutes;c__Bacilli;o__Gemellales
testkevin151	k__Bacteria;p__Firmicutes;c__Bacilli;o__Lactobacillales
testkevin152	k__Bacteria;p__Firmicutes;c__Bacilli;o__Turicibacterales
testkevin153	k__Bacteria;p__Firmicutes;c__Clostridia;Other
testkevin154	k__Bacteria;p__Firmicutes;c__Clostridia;o__
testkevin155	k__Bacteria;p__Firmicutes;c__Clostridia;o__Clostridiales
testkevin156	k__Bacteria;p__Firmicutes;c__Clostridia;o__SHA-98
testkevin157	k__Bacteria;p__Firmicutes;c__Erysipelotrichi;o__Erysipelotrichales
testkevin158	k__Bacteria;p__Fusobacteria;c__Fusobacteriia;o__Fusobacteriales
testkevin159	k__Bacteria;p__GN02;c__3BR-5F;o__
testkevin160	k__Bacteria;p__Gemmatimonadetes;c__Gemm-2;o__
testkevin161	k__Bacteria;p__Gemmatimonadetes;c__Gemm-3;o__
testkevin162	k__Bacteria;p__Gemmatimonadetes;c__Gemm-5;o__
testkevin163	k__Bacteria;p__Gemmatimonadetes;c__Gemmatimonadetes;o__
testkevin164	k__Bacteria;p__Lentisphaerae;c__[Lentisphaeria];o__Victivallales
testkevin165	k__Bacteria;p__OP1;c__[Acetothermia];o__[Acetothermales]
testkevin166	k__Bacteria;p__OP8;c__OP8_2;o__
testkevin167	k__Bacteria;p__Planctomycetes;Other;Other
testkevin168	k__Bacteria;p__Planctomycetes;c__;o__
testkevin169	k__Bacteria;p__Planctomycetes;c__OM190;o__agg27
testkevin170	k__Bacteria;p__Planctomycetes;c__Phycisphaerae;Other
testkevin171	k__Bacteria;p__Planctomycetes;c__Phycisphaerae;o__Phycisphaerales
testkevin172	k__Bacteria;p__Planctomycetes;c__Phycisphaerae;o__mle1-8
testkevin173	k__Bacteria;p__Proteobacteria;Other;Other
testkevin174	k__Bacteria;p__Proteobacteria;c__Alphaproteobacteria;Other
testkevin175	k__Bacteria;p__Proteobacteria;c__Alphaproteobacteria;o__Caulobacterales
testkevin176	k__Bacteria;p__Proteobacteria;c__Alphaproteobacteria;o__RF32
testkevin177	k__Bacteria;p__Proteobacteria;c__Alphaproteobacteria;o__Rhizobiales
testkevin178	k__Bacteria;p__Proteobacteria;c__Alphaproteobacteria;o__Rhodobacterales
testkevin179	k__Bacteria;p__Proteobacteria;c__Alphaproteobacteria;o__Sphingomonadales
testkevin180	k__Bacteria;p__Proteobacteria;c__Betaproteobacteria;Other
testkevin181	k__Bacteria;p__Proteobacteria;c__Betaproteobacteria;o__
testkevin182	k__Bacteria;p__Proteobacteria;c__Betaproteobacteria;o__Burkholderiales
testkevin183	k__Bacteria;p__Proteobacteria;c__Betaproteobacteria;o__Gallionellales
testkevin184	k__Bacteria;p__Proteobacteria;c__Betaproteobacteria;o__Methylophilales
testkevin185	k__Bacteria;p__Proteobacteria;c__Betaproteobacteria;o__Neisseriales
testkevin186	k__Bacteria;p__Proteobacteria;c__Betaproteobacteria;o__Rhodocyclales
testkevin187	k__Bacteria;p__Proteobacteria;c__Deltaproteobacteria;Other
testkevin188	k__Bacteria;p__Proteobacteria;c__Deltaproteobacteria;o__
testkevin189	k__Bacteria;p__Proteobacteria;c__Deltaproteobacteria;o__Desulfobacterales
testkevin190	k__Bacteria;p__Proteobacteria;c__Deltaproteobacteria;o__Desulfovibrionales
testkevin191	k__Bacteria;p__Proteobacteria;c__Deltaproteobacteria;o__Myxococcales
testkevin192	k__Bacteria;p__Proteobacteria;c__Deltaproteobacteria;o__PB19
testkevin193	k__Bacteria;p__Proteobacteria;c__Deltaproteobacteria;o__Syntrophobacterales
testkevin194	k__Bacteria;p__Proteobacteria;c__Deltaproteobacteria;o__Thermodesulfobacteriales
testkevin195	k__Bacteria;p__Proteobacteria;c__Epsilonproteobacteria;o__Campylobacterales
testkevin196	k__Bacteria;p__Proteobacteria;c__Gammaproteobacteria;Other
testkevin197	k__Bacteria;p__Proteobacteria;c__Gammaproteobacteria;o__Aeromonadales
testkevin198	k__Bacteria;p__Proteobacteria;c__Gammaproteobacteria;o__Alteromonadales
testkevin199	k__Bacteria;p__Proteobacteria;c__Gammaproteobacteria;o__Cardiobacteriales
testkevin200	k__Bacteria;p__Proteobacteria;c__Gammaproteobacteria;o__Enterobacteriales
testkevin201	k__Bacteria;p__Proteobacteria;c__Gammaproteobacteria;o__Legionellales
testkevin202	k__Bacteria;p__Proteobacteria;c__Gammaproteobacteria;o__Oceanospirillales
testkevin203	k__Bacteria;p__Proteobacteria;c__Gammaproteobacteria;o__Pasteurellales
testkevin204	k__Bacteria;p__Proteobacteria;c__Gammaproteobacteria;o__Pseudomonadales
testkevin205	k__Bacteria;p__Proteobacteria;c__Gammaproteobacteria;o__Thiotrichales
testkevin206	k__Bacteria;p__Proteobacteria;c__Gammaproteobacteria;o__Vibrionales
testkevin207	k__Bacteria;p__Proteobacteria;c__Gammaproteobacteria;o__Xanthomonadales
testkevin208	k__Bacteria;p__SAR406;c__AB16;o__
testkevin209	k__Bacteria;p__SAR406;c__AB16;o__SSW63Au
testkevin210	k__Bacteria;p__SR1;c__;o__
testkevin211	k__Bacteria;p__Synergistetes;c__Synergistia;o__Synergistales
testkevin212	k__Bacteria;p__TM7;c__TM7-3;o__
testkevin213	k__Bacteria;p__TM7;c__TM7-3;o__CW040
testkevin214	k__Bacteria;p__Tenericutes;c__Mollicutes;o__RF39
testkevin215	k__Bacteria;p__Tenericutes;c__RF3;o__ML615J-28
testkevin216	k__Bacteria;p__Verrucomicrobia;Other;Other
testkevin217	k__Bacteria;p__Verrucomicrobia;c__Opitutae;o__Puniceicoccales
testkevin218	k__Bacteria;p__Verrucomicrobia;c__Opitutae;o__[Cerasicoccales]
testkevin219	k__Bacteria;p__Verrucomicrobia;c__Verrucomicrobiae;o__Verrucomicrobiales
testkevin220	k__Bacteria;p__WS3;c__PRR-12;o__Sediment-1
testkevin221	k__Bacteria;p__[Thermi];c__Deinococci;o__Deinococcales
testkevin222	Unassigned;Other;Other;Other;Other
testkevin223	k__Archaea;Other;Other;Other;Other
testkevin224	k__Archaea;p__Crenarchaeota;Other;Other;Other
testkevin225	k__Archaea;p__Crenarchaeota;c__MBGA;o__NRP-J;f__
testkevin226	k__Archaea;p__Crenarchaeota;c__MCG;o__pGrfC26;f__
testkevin227	k__Archaea;p__Crenarchaeota;c__Thaumarchaeota;o__Cenarchaeales;f__Cenarchaeaceae
testkevin228	k__Archaea;p__Crenarchaeota;c__Thermoprotei;o__Desulfurococcales;f__Desulfurococcaceae
testkevin229	k__Archaea;p__Crenarchaeota;c__Thermoprotei;o__Thermoproteales;f__Thermoproteaceae
testkevin230	k__Archaea;p__Euryarchaeota;Other;Other;Other
testkevin231	k__Archaea;p__Euryarchaeota;c__ANME-1;o__;f__
testkevin232	k__Archaea;p__Euryarchaeota;c__DSEG;o__DHVE3;f__
testkevin233	k__Archaea;p__Euryarchaeota;c__Halobacteria;o__Halobacteriales;f__Halobacteriaceae
testkevin234	k__Archaea;p__Euryarchaeota;c__Methanomicrobia;o__Methanomicrobiales;Other
testkevin235	k__Archaea;p__Euryarchaeota;c__Methanomicrobia;o__Methanomicrobiales;f__Methanomicrobiaceae
testkevin236	k__Archaea;p__Euryarchaeota;c__Methanomicrobia;o__Methanomicrobiales;f__Methanoregulaceae
testkevin237	k__Archaea;p__Euryarchaeota;c__Methanomicrobia;o__Methanosarcinales;f__ANME-2D
testkevin238	k__Archaea;p__Euryarchaeota;c__Thermoplasmata;o__Thermoplasmatales;f__Picrophilaceae
testkevin239	k__Bacteria;Other;Other;Other;Other
testkevin240	k__Bacteria;p__Acidobacteria;c__Acidobacteria-6;Other;Other
testkevin241	k__Bacteria;p__Actinobacteria;Other;Other;Other
testkevin242	k__Bacteria;p__Actinobacteria;c__Acidimicrobiia;o__Acidimicrobiales;Other
testkevin243	k__Bacteria;p__Actinobacteria;c__Actinobacteria;o__Actinomycetales;Other
testkevin244	k__Bacteria;p__Actinobacteria;c__Actinobacteria;o__Actinomycetales;f__Actinomycetaceae
testkevin245	k__Bacteria;p__Actinobacteria;c__Actinobacteria;o__Actinomycetales;f__Brevibacteriaceae
testkevin246	k__Bacteria;p__Actinobacteria;c__Actinobacteria;o__Actinomycetales;f__Corynebacteriaceae
testkevin247	k__Bacteria;p__Actinobacteria;c__Actinobacteria;o__Actinomycetales;f__Dietziaceae
testkevin248	k__Bacteria;p__Actinobacteria;c__Actinobacteria;o__Actinomycetales;f__Microbacteriaceae
testkevin249	k__Bacteria;p__Actinobacteria;c__Actinobacteria;o__Actinomycetales;f__Promicromonosporaceae
testkevin250	k__Bacteria;p__Actinobacteria;c__Actinobacteria;o__Actinomycetales;f__Propionibacteriaceae
testkevin251	k__Bacteria;p__Actinobacteria;c__Actinobacteria;o__Bifidobacteriales;f__Bifidobacteriaceae
testkevin252	k__Bacteria;p__Actinobacteria;c__Coriobacteriia;o__Coriobacteriales;f__Coriobacteriaceae
testkevin253	k__Bacteria;p__Actinobacteria;c__OPB41;o__;f__
testkevin254	k__Bacteria;p__Actinobacteria;c__Thermoleophilia;Other;Other
testkevin255	k__Bacteria;p__Actinobacteria;c__Thermoleophilia;o__Solirubrobacterales;f__
testkevin256	k__Bacteria;p__Bacteroidetes;Other;Other;Other
testkevin257	k__Bacteria;p__Bacteroidetes;c__Bacteroidia;o__Bacteroidales;Other
testkevin258	k__Bacteria;p__Bacteroidetes;c__Bacteroidia;o__Bacteroidales;f__
testkevin259	k__Bacteria;p__Bacteroidetes;c__Bacteroidia;o__Bacteroidales;f__Bacteroidaceae
testkevin260	k__Bacteria;p__Bacteroidetes;c__Bacteroidia;o__Bacteroidales;f__Marinilabiaceae
testkevin261	k__Bacteria;p__Bacteroidetes;c__Bacteroidia;o__Bacteroidales;f__Porphyromonadaceae
testkevin262	k__Bacteria;p__Bacteroidetes;c__Bacteroidia;o__Bacteroidales;f__Prevotellaceae
testkevin263	k__Bacteria;p__Bacteroidetes;c__Bacteroidia;o__Bacteroidales;f__Rikenellaceae
testkevin264	k__Bacteria;p__Bacteroidetes;c__Bacteroidia;o__Bacteroidales;f__S24-7
testkevin265	k__Bacteria;p__Bacteroidetes;c__Bacteroidia;o__Bacteroidales;f__[Barnesiellaceae]
testkevin266	k__Bacteria;p__Bacteroidetes;c__Bacteroidia;o__Bacteroidales;f__[Odoribacteraceae]
testkevin267	k__Bacteria;p__Bacteroidetes;c__Bacteroidia;o__Bacteroidales;f__[Paraprevotellaceae]
testkevin268	k__Bacteria;p__Bacteroidetes;c__Cytophagia;o__Cytophagales;f__Cytophagaceae
testkevin269	k__Bacteria;p__Bacteroidetes;c__Flavobacteriia;o__Flavobacteriales;Other
testkevin270	k__Bacteria;p__Bacteroidetes;c__Flavobacteriia;o__Flavobacteriales;f__Flavobacteriaceae
testkevin271	k__Bacteria;p__Bacteroidetes;c__Flavobacteriia;o__Flavobacteriales;f__[Weeksellaceae]
testkevin272	k__Bacteria;p__Bacteroidetes;c__Sphingobacteriia;o__Sphingobacteriales;f__Sphingobacteriaceae
testkevin273	k__Bacteria;p__Bacteroidetes;c__[Saprospirae];o__[Saprospirales];f__Chitinophagaceae
testkevin274	k__Bacteria;p__Chloroflexi;Other;Other;Other
testkevin275	k__Bacteria;p__Chloroflexi;c__Anaerolineae;Other;Other
testkevin276	k__Bacteria;p__Chloroflexi;c__Anaerolineae;o__CFB-26;f__
testkevin277	k__Bacteria;p__Chloroflexi;c__Anaerolineae;o__OPB11;f__
testkevin278	k__Bacteria;p__Chloroflexi;c__Anaerolineae;o__S0208;f__
testkevin279	k__Bacteria;p__Chloroflexi;c__Anaerolineae;o__SBR1031;f__A4b
testkevin280	k__Bacteria;p__Chloroflexi;c__Anaerolineae;o__SBR1031;f__SJA-101
testkevin281	k__Bacteria;p__Chloroflexi;c__Chloroflexi;o__[Roseiflexales];f__
testkevin282	k__Bacteria;p__Chloroflexi;c__Dehalococcoidetes;o__Dehalococcoidales;f__Dehalococcoidaceae
testkevin283	k__Bacteria;p__Chloroflexi;c__Ktedonobacteria;o__B12-WMSP1;f__
testkevin284	k__Bacteria;p__Chloroflexi;c__SAR202;o__;f__
testkevin285	k__Bacteria;p__Cyanobacteria;Other;Other;Other
testkevin286	k__Bacteria;p__Cyanobacteria;c__4C0d-2;o__MLE1-12;f__
testkevin287	k__Bacteria;p__Cyanobacteria;c__4C0d-2;o__YS2;f__
testkevin288	k__Bacteria;p__Cyanobacteria;c__Chloroplast;o__Chlorophyta;f__
testkevin289	k__Bacteria;p__Cyanobacteria;c__Chloroplast;o__Streptophyta;f__
testkevin290	k__Bacteria;p__Cyanobacteria;c__Nostocophycideae;o__Nostocales;Other
testkevin291	k__Bacteria;p__Cyanobacteria;c__Synechococcophycideae;o__Pseudanabaenales;f__Pseudanabaenaceae
testkevin292	k__Bacteria;p__Firmicutes;Other;Other;Other
testkevin293	k__Bacteria;p__Firmicutes;c__Bacilli;Other;Other
testkevin294	k__Bacteria;p__Firmicutes;c__Bacilli;o__Bacillales;Other
testkevin295	k__Bacteria;p__Firmicutes;c__Bacilli;o__Bacillales;f__Bacillaceae
testkevin296	k__Bacteria;p__Firmicutes;c__Bacilli;o__Bacillales;f__Planococcaceae
testkevin297	k__Bacteria;p__Firmicutes;c__Bacilli;o__Bacillales;f__Staphylococcaceae
testkevin298	k__Bacteria;p__Firmicutes;c__Bacilli;o__Gemellales;f__Gemellaceae
testkevin299	k__Bacteria;p__Firmicutes;c__Bacilli;o__Lactobacillales;Other
testkevin300	k__Bacteria;p__Firmicutes;c__Bacilli;o__Lactobacillales;f__
testkevin301	k__Bacteria;p__Firmicutes;c__Bacilli;o__Lactobacillales;f__Aerococcaceae
testkevin302	k__Bacteria;p__Firmicutes;c__Bacilli;o__Lactobacillales;f__Carnobacteriaceae
testkevin303	k__Bacteria;p__Firmicutes;c__Bacilli;o__Lactobacillales;f__Enterococcaceae
testkevin304	k__Bacteria;p__Firmicutes;c__Bacilli;o__Lactobacillales;f__Lactobacillaceae
testkevin305	k__Bacteria;p__Firmicutes;c__Bacilli;o__Lactobacillales;f__Leuconostocaceae
testkevin306	k__Bacteria;p__Firmicutes;c__Bacilli;o__Lactobacillales;f__Streptococcaceae
testkevin307	k__Bacteria;p__Firmicutes;c__Bacilli;o__Turicibacterales;f__Turicibacteraceae
testkevin308	k__Bacteria;p__Firmicutes;c__Clostridia;Other;Other
testkevin309	k__Bacteria;p__Firmicutes;c__Clostridia;o__;f__
testkevin310	k__Bacteria;p__Firmicutes;c__Clostridia;o__Clostridiales;Other
testkevin311	k__Bacteria;p__Firmicutes;c__Clostridia;o__Clostridiales;f__
testkevin312	k__Bacteria;p__Firmicutes;c__Clostridia;o__Clostridiales;f__Christensenellaceae
testkevin313	k__Bacteria;p__Firmicutes;c__Clostridia;o__Clostridiales;f__Clostridiaceae
testkevin314	k__Bacteria;p__Firmicutes;c__Clostridia;o__Clostridiales;f__Dehalobacteriaceae
testkevin315	k__Bacteria;p__Firmicutes;c__Clostridia;o__Clostridiales;f__EtOH8
testkevin316	k__Bacteria;p__Firmicutes;c__Clostridia;o__Clostridiales;f__Eubacteriaceae
testkevin317	k__Bacteria;p__Firmicutes;c__Clostridia;o__Clostridiales;f__Lachnospiraceae
testkevin318	k__Bacteria;p__Firmicutes;c__Clostridia;o__Clostridiales;f__Peptococcaceae
testkevin319	k__Bacteria;p__Firmicutes;c__Clostridia;o__Clostridiales;f__Peptostreptococcaceae
testkevin320	k__Bacteria;p__Firmicutes;c__Clostridia;o__Clostridiales;f__Ruminococcaceae
testkevin321	k__Bacteria;p__Firmicutes;c__Clostridia;o__Clostridiales;f__Veillonellaceae
testkevin322	k__Bacteria;p__Firmicutes;c__Clostridia;o__Clostridiales;f__[Mogibacteriaceae]
testkevin323	k__Bacteria;p__Firmicutes;c__Clostridia;o__Clostridiales;f__[Tissierellaceae]
testkevin324	k__Bacteria;p__Firmicutes;c__Clostridia;o__SHA-98;f__
testkevin325	k__Bacteria;p__Firmicutes;c__Erysipelotrichi;o__Erysipelotrichales;f__Erysipelotrichaceae
testkevin326	k__Bacteria;p__Fusobacteria;c__Fusobacteriia;o__Fusobacteriales;Other
testkevin327	k__Bacteria;p__Fusobacteria;c__Fusobacteriia;o__Fusobacteriales;f__Fusobacteriaceae
testkevin328	k__Bacteria;p__Fusobacteria;c__Fusobacteriia;o__Fusobacteriales;f__Leptotrichiaceae
testkevin329	k__Bacteria;p__GN02;c__3BR-5F;o__;f__
testkevin330	k__Bacteria;p__Gemmatimonadetes;c__Gemm-2;o__;f__
testkevin331	k__Bacteria;p__Gemmatimonadetes;c__Gemm-3;o__;f__
testkevin332	k__Bacteria;p__Gemmatimonadetes;c__Gemm-5;o__;f__
testkevin333	k__Bacteria;p__Gemmatimonadetes;c__Gemmatimonadetes;o__;f__
testkevin334	k__Bacteria;p__Lentisphaerae;c__[Lentisphaeria];o__Victivallales;f__Victivallaceae
testkevin335	k__Bacteria;p__OP1;c__[Acetothermia];o__[Acetothermales];f__
testkevin336	k__Bacteria;p__OP8;c__OP8_2;o__;f__
testkevin337	k__Bacteria;p__Planctomycetes;Other;Other;Other
testkevin338	k__Bacteria;p__Planctomycetes;c__;o__;f__
testkevin339	k__Bacteria;p__Planctomycetes;c__OM190;o__agg27;f__
testkevin340	k__Bacteria;p__Planctomycetes;c__Phycisphaerae;Other;Other
testkevin341	k__Bacteria;p__Planctomycetes;c__Phycisphaerae;o__Phycisphaerales;f__
testkevin342	k__Bacteria;p__Planctomycetes;c__Phycisphaerae;o__mle1-8;f__
testkevin343	k__Bacteria;p__Proteobacteria;Other;Other;Other
testkevin344	k__Bacteria;p__Proteobacteria;c__Alphaproteobacteria;Other;Other
testkevin345	k__Bacteria;p__Proteobacteria;c__Alphaproteobacteria;o__Caulobacterales;f__Caulobacteraceae
testkevin346	k__Bacteria;p__Proteobacteria;c__Alphaproteobacteria;o__RF32;f__
testkevin347	k__Bacteria;p__Proteobacteria;c__Alphaproteobacteria;o__Rhizobiales;Other
testkevin348	k__Bacteria;p__Proteobacteria;c__Alphaproteobacteria;o__Rhizobiales;f__
testkevin349	k__Bacteria;p__Proteobacteria;c__Alphaproteobacteria;o__Rhizobiales;f__Beijerinckiaceae
testkevin350	k__Bacteria;p__Proteobacteria;c__Alphaproteobacteria;o__Rhizobiales;f__Bradyrhizobiaceae
testkevin351	k__Bacteria;p__Proteobacteria;c__Alphaproteobacteria;o__Rhizobiales;f__Hyphomicrobiaceae
testkevin352	k__Bacteria;p__Proteobacteria;c__Alphaproteobacteria;o__Rhizobiales;f__Methylobacteriaceae
testkevin353	k__Bacteria;p__Proteobacteria;c__Alphaproteobacteria;o__Rhizobiales;f__Phyllobacteriaceae
testkevin354	k__Bacteria;p__Proteobacteria;c__Alphaproteobacteria;o__Rhodobacterales;f__Rhodobacteraceae
testkevin355	k__Bacteria;p__Proteobacteria;c__Alphaproteobacteria;o__Sphingomonadales;f__Sphingomonadaceae
testkevin356	k__Bacteria;p__Proteobacteria;c__Betaproteobacteria;Other;Other
testkevin357	k__Bacteria;p__Proteobacteria;c__Betaproteobacteria;o__;f__
testkevin358	k__Bacteria;p__Proteobacteria;c__Betaproteobacteria;o__Burkholderiales;Other
testkevin359	k__Bacteria;p__Proteobacteria;c__Betaproteobacteria;o__Burkholderiales;f__Alcaligenaceae
testkevin360	k__Bacteria;p__Proteobacteria;c__Betaproteobacteria;o__Burkholderiales;f__Burkholderiaceae
testkevin361	k__Bacteria;p__Proteobacteria;c__Betaproteobacteria;o__Burkholderiales;f__Comamonadaceae
testkevin362	k__Bacteria;p__Proteobacteria;c__Betaproteobacteria;o__Burkholderiales;f__Oxalobacteraceae
testkevin363	k__Bacteria;p__Proteobacteria;c__Betaproteobacteria;o__Gallionellales;f__Gallionellaceae
testkevin364	k__Bacteria;p__Proteobacteria;c__Betaproteobacteria;o__Methylophilales;f__Methylophilaceae
testkevin365	k__Bacteria;p__Proteobacteria;c__Betaproteobacteria;o__Neisseriales;f__Neisseriaceae
testkevin366	k__Bacteria;p__Proteobacteria;c__Betaproteobacteria;o__Rhodocyclales;f__Rhodocyclaceae
testkevin367	k__Bacteria;p__Proteobacteria;c__Deltaproteobacteria;Other;Other
testkevin368	k__Bacteria;p__Proteobacteria;c__Deltaproteobacteria;o__;f__
testkevin369	k__Bacteria;p__Proteobacteria;c__Deltaproteobacteria;o__Desulfobacterales;f__Desulfobulbaceae
testkevin370	k__Bacteria;p__Proteobacteria;c__Deltaproteobacteria;o__Desulfovibrionales;f__Desulfovibrionaceae
testkevin371	k__Bacteria;p__Proteobacteria;c__Deltaproteobacteria;o__Myxococcales;Other
testkevin372	k__Bacteria;p__Proteobacteria;c__Deltaproteobacteria;o__Myxococcales;f__
testkevin373	k__Bacteria;p__Proteobacteria;c__Deltaproteobacteria;o__Myxococcales;f__Haliangiaceae
testkevin374	k__Bacteria;p__Proteobacteria;c__Deltaproteobacteria;o__PB19;f__
testkevin375	k__Bacteria;p__Proteobacteria;c__Deltaproteobacteria;o__Syntrophobacterales;f__Syntrophobacteraceae
testkevin376	k__Bacteria;p__Proteobacteria;c__Deltaproteobacteria;o__Thermodesulfobacteriales;f__
testkevin377	k__Bacteria;p__Proteobacteria;c__Epsilonproteobacteria;o__Campylobacterales;f__Campylobacteraceae
testkevin378	k__Bacteria;p__Proteobacteria;c__Gammaproteobacteria;Other;Other
testkevin379	k__Bacteria;p__Proteobacteria;c__Gammaproteobacteria;o__Aeromonadales;f__Aeromonadaceae
testkevin380	k__Bacteria;p__Proteobacteria;c__Gammaproteobacteria;o__Alteromonadales;Other
testkevin381	k__Bacteria;p__Proteobacteria;c__Gammaproteobacteria;o__Alteromonadales;f__Alteromonadaceae
testkevin382	k__Bacteria;p__Proteobacteria;c__Gammaproteobacteria;o__Cardiobacteriales;f__Cardiobacteriaceae
testkevin383	k__Bacteria;p__Proteobacteria;c__Gammaproteobacteria;o__Enterobacteriales;f__Enterobacteriaceae
testkevin384	k__Bacteria;p__Proteobacteria;c__Gammaproteobacteria;o__Legionellales;f__Coxiellaceae
testkevin385	k__Bacteria;p__Proteobacteria;c__Gammaproteobacteria;o__Legionellales;f__Francisellaceae
testkevin386	k__Bacteria;p__Proteobacteria;c__Gammaproteobacteria;o__Oceanospirillales;f__Oceanospirillaceae
testkevin387	k__Bacteria;p__Proteobacteria;c__Gammaproteobacteria;o__Pasteurellales;f__Pasteurellaceae
testkevin388	k__Bacteria;p__Proteobacteria;c__Gammaproteobacteria;o__Pseudomonadales;Other
testkevin389	k__Bacteria;p__Proteobacteria;c__Gammaproteobacteria;o__Pseudomonadales;f__Moraxellaceae
testkevin390	k__Bacteria;p__Proteobacteria;c__Gammaproteobacteria;o__Pseudomonadales;f__Pseudomonadaceae
testkevin391	k__Bacteria;p__Proteobacteria;c__Gammaproteobacteria;o__Thiotrichales;f__Piscirickettsiaceae
testkevin392	k__Bacteria;p__Proteobacteria;c__Gammaproteobacteria;o__Vibrionales;f__Pseudoalteromonadaceae
testkevin393	k__Bacteria;p__Proteobacteria;c__Gammaproteobacteria;o__Vibrionales;f__Vibrionaceae
testkevin394	k__Bacteria;p__Proteobacteria;c__Gammaproteobacteria;o__Xanthomonadales;f__Sinobacteraceae
testkevin395	k__Bacteria;p__Proteobacteria;c__Gammaproteobacteria;o__Xanthomonadales;f__Xanthomonadaceae
testkevin396	k__Bacteria;p__SAR406;c__AB16;o__;f__
testkevin397	k__Bacteria;p__SAR406;c__AB16;o__SSW63Au;f__SHAS460
testkevin398	k__Bacteria;p__SR1;c__;o__;f__
testkevin399	k__Bacteria;p__Synergistetes;c__Synergistia;o__Synergistales;f__Dethiosulfovibrionaceae
testkevin400	k__Bacteria;p__TM7;c__TM7-3;o__;f__
testkevin401	k__Bacteria;p__TM7;c__TM7-3;o__CW040;f__
testkevin402	k__Bacteria;p__TM7;c__TM7-3;o__CW040;f__F16
testkevin403	k__Bacteria;p__Tenericutes;c__Mollicutes;o__RF39;f__
testkevin404	k__Bacteria;p__Tenericutes;c__RF3;o__ML615J-28;f__
testkevin405	k__Bacteria;p__Verrucomicrobia;Other;Other;Other
testkevin406	k__Bacteria;p__Verrucomicrobia;c__Opitutae;o__Puniceicoccales;f__Puniceicoccaceae
testkevin407	k__Bacteria;p__Verrucomicrobia;c__Opitutae;o__[Cerasicoccales];f__[Cerasicoccaceae]
testkevin408	k__Bacteria;p__Verrucomicrobia;c__Verrucomicrobiae;o__Verrucomicrobiales;f__Verrucomicrobiaceae
testkevin409	k__Bacteria;p__WS3;c__PRR-12;o__Sediment-1;f__
testkevin410	k__Bacteria;p__[Thermi];c__Deinococci;o__Deinococcales;f__Deinococcaceae
testkevin411	Unassigned;Other;Other;Other;Other;Other
testkevin412	k__Archaea;Other;Other;Other;Other;Other
testkevin413	k__Archaea;p__Crenarchaeota;Other;Other;Other;Other
testkevin414	k__Archaea;p__Crenarchaeota;c__MBGA;o__NRP-J;f__;g__
testkevin415	k__Archaea;p__Crenarchaeota;c__MCG;o__pGrfC26;f__;g__
testkevin416	k__Archaea;p__Crenarchaeota;c__Thaumarchaeota;o__Cenarchaeales;f__Cenarchaeaceae;g__Nitrosopumilus
testkevin417	k__Archaea;p__Crenarchaeota;c__Thermoprotei;o__Desulfurococcales;f__Desulfurococcaceae;Other
testkevin418	k__Archaea;p__Crenarchaeota;c__Thermoprotei;o__Thermoproteales;f__Thermoproteaceae;g__
testkevin419	k__Archaea;p__Euryarchaeota;Other;Other;Other;Other
testkevin420	k__Archaea;p__Euryarchaeota;c__ANME-1;o__;f__;g__
testkevin421	k__Archaea;p__Euryarchaeota;c__DSEG;o__DHVE3;f__;g__
testkevin422	k__Archaea;p__Euryarchaeota;c__Halobacteria;o__Halobacteriales;f__Halobacteriaceae;Other
testkevin423	k__Archaea;p__Euryarchaeota;c__Methanomicrobia;o__Methanomicrobiales;Other;Other
testkevin424	k__Archaea;p__Euryarchaeota;c__Methanomicrobia;o__Methanomicrobiales;f__Methanomicrobiaceae;g__Methanoplanus
testkevin425	k__Archaea;p__Euryarchaeota;c__Methanomicrobia;o__Methanomicrobiales;f__Methanoregulaceae;g__Candidatus Methanoregula
testkevin426	k__Archaea;p__Euryarchaeota;c__Methanomicrobia;o__Methanosarcinales;f__ANME-2D;g__
testkevin427	k__Archaea;p__Euryarchaeota;c__Thermoplasmata;o__Thermoplasmatales;f__Picrophilaceae;g__Thermogymnomonas
testkevin428	k__Bacteria;Other;Other;Other;Other;Other
testkevin429	k__Bacteria;p__Acidobacteria;c__Acidobacteria-6;Other;Other;Other
testkevin430	k__Bacteria;p__Actinobacteria;Other;Other;Other;Other
testkevin431	k__Bacteria;p__Actinobacteria;c__Acidimicrobiia;o__Acidimicrobiales;Other;Other
testkevin432	k__Bacteria;p__Actinobacteria;c__Actinobacteria;o__Actinomycetales;Other;Other
testkevin433	k__Bacteria;p__Actinobacteria;c__Actinobacteria;o__Actinomycetales;f__Actinomycetaceae;Other
testkevin434	k__Bacteria;p__Actinobacteria;c__Actinobacteria;o__Actinomycetales;f__Actinomycetaceae;g__
testkevin435	k__Bacteria;p__Actinobacteria;c__Actinobacteria;o__Actinomycetales;f__Actinomycetaceae;g__Actinomyces
testkevin436	k__Bacteria;p__Actinobacteria;c__Actinobacteria;o__Actinomycetales;f__Brevibacteriaceae;g__Brevibacterium
testkevin437	k__Bacteria;p__Actinobacteria;c__Actinobacteria;o__Actinomycetales;f__Corynebacteriaceae;g__Corynebacterium
testkevin438	k__Bacteria;p__Actinobacteria;c__Actinobacteria;o__Actinomycetales;f__Dietziaceae;g__Dietzia
testkevin439	k__Bacteria;p__Actinobacteria;c__Actinobacteria;o__Actinomycetales;f__Microbacteriaceae;g__
testkevin440	k__Bacteria;p__Actinobacteria;c__Actinobacteria;o__Actinomycetales;f__Microbacteriaceae;g__Microbacterium
testkevin441	k__Bacteria;p__Actinobacteria;c__Actinobacteria;o__Actinomycetales;f__Promicromonosporaceae;g__Cellulosimicrobium
testkevin442	k__Bacteria;p__Actinobacteria;c__Actinobacteria;o__Actinomycetales;f__Propionibacteriaceae;Other
testkevin443	k__Bacteria;p__Actinobacteria;c__Actinobacteria;o__Actinomycetales;f__Propionibacteriaceae;g__Propionibacterium
testkevin444	k__Bacteria;p__Actinobacteria;c__Actinobacteria;o__Bifidobacteriales;f__Bifidobacteriaceae;g__Bifidobacterium
testkevin445	k__Bacteria;p__Actinobacteria;c__Coriobacteriia;o__Coriobacteriales;f__Coriobacteriaceae;Other
testkevin446	k__Bacteria;p__Actinobacteria;c__Coriobacteriia;o__Coriobacteriales;f__Coriobacteriaceae;g__
testkevin447	k__Bacteria;p__Actinobacteria;c__Coriobacteriia;o__Coriobacteriales;f__Coriobacteriaceae;g__Adlercreutzia
testkevin448	k__Bacteria;p__Actinobacteria;c__Coriobacteriia;o__Coriobacteriales;f__Coriobacteriaceae;g__Atopobium
testkevin449	k__Bacteria;p__Actinobacteria;c__Coriobacteriia;o__Coriobacteriales;f__Coriobacteriaceae;g__Collinsella
testkevin450	k__Bacteria;p__Actinobacteria;c__Coriobacteriia;o__Coriobacteriales;f__Coriobacteriaceae;g__Eggerthella
testkevin451	k__Bacteria;p__Actinobacteria;c__Coriobacteriia;o__Coriobacteriales;f__Coriobacteriaceae;g__Slackia
testkevin452	k__Bacteria;p__Actinobacteria;c__OPB41;o__;f__;g__
testkevin453	k__Bacteria;p__Actinobacteria;c__Thermoleophilia;Other;Other;Other
testkevin454	k__Bacteria;p__Actinobacteria;c__Thermoleophilia;o__Solirubrobacterales;f__;g__
testkevin455	k__Bacteria;p__Bacteroidetes;Other;Other;Other;Other
testkevin456	k__Bacteria;p__Bacteroidetes;c__Bacteroidia;o__Bacteroidales;Other;Other
testkevin457	k__Bacteria;p__Bacteroidetes;c__Bacteroidia;o__Bacteroidales;f__;g__
testkevin458	k__Bacteria;p__Bacteroidetes;c__Bacteroidia;o__Bacteroidales;f__Bacteroidaceae;Other
testkevin459	k__Bacteria;p__Bacteroidetes;c__Bacteroidia;o__Bacteroidales;f__Bacteroidaceae;g__
testkevin460	k__Bacteria;p__Bacteroidetes;c__Bacteroidia;o__Bacteroidales;f__Bacteroidaceae;g__Bacteroides
testkevin461	k__Bacteria;p__Bacteroidetes;c__Bacteroidia;o__Bacteroidales;f__Marinilabiaceae;g__
testkevin462	k__Bacteria;p__Bacteroidetes;c__Bacteroidia;o__Bacteroidales;f__Porphyromonadaceae;Other
testkevin463	k__Bacteria;p__Bacteroidetes;c__Bacteroidia;o__Bacteroidales;f__Porphyromonadaceae;g__
testkevin464	k__Bacteria;p__Bacteroidetes;c__Bacteroidia;o__Bacteroidales;f__Porphyromonadaceae;g__Candidatus Azobacteroides
testkevin465	k__Bacteria;p__Bacteroidetes;c__Bacteroidia;o__Bacteroidales;f__Porphyromonadaceae;g__Dysgonomonas
testkevin466	k__Bacteria;p__Bacteroidetes;c__Bacteroidia;o__Bacteroidales;f__Porphyromonadaceae;g__Parabacteroides
testkevin467	k__Bacteria;p__Bacteroidetes;c__Bacteroidia;o__Bacteroidales;f__Porphyromonadaceae;g__Porphyromonas
testkevin468	k__Bacteria;p__Bacteroidetes;c__Bacteroidia;o__Bacteroidales;f__Prevotellaceae;Other
testkevin469	k__Bacteria;p__Bacteroidetes;c__Bacteroidia;o__Bacteroidales;f__Prevotellaceae;g__Prevotella
testkevin470	k__Bacteria;p__Bacteroidetes;c__Bacteroidia;o__Bacteroidales;f__Rikenellaceae;Other
testkevin471	k__Bacteria;p__Bacteroidetes;c__Bacteroidia;o__Bacteroidales;f__Rikenellaceae;g__
testkevin472	k__Bacteria;p__Bacteroidetes;c__Bacteroidia;o__Bacteroidales;f__Rikenellaceae;g__Alistipes
testkevin473	k__Bacteria;p__Bacteroidetes;c__Bacteroidia;o__Bacteroidales;f__S24-7;g__
testkevin474	k__Bacteria;p__Bacteroidetes;c__Bacteroidia;o__Bacteroidales;f__[Barnesiellaceae];Other
testkevin475	k__Bacteria;p__Bacteroidetes;c__Bacteroidia;o__Bacteroidales;f__[Barnesiellaceae];g__
testkevin476	k__Bacteria;p__Bacteroidetes;c__Bacteroidia;o__Bacteroidales;f__[Odoribacteraceae];Other
testkevin477	k__Bacteria;p__Bacteroidetes;c__Bacteroidia;o__Bacteroidales;f__[Odoribacteraceae];g__Butyricimonas
testkevin478	k__Bacteria;p__Bacteroidetes;c__Bacteroidia;o__Bacteroidales;f__[Odoribacteraceae];g__Odoribacter
testkevin479	k__Bacteria;p__Bacteroidetes;c__Bacteroidia;o__Bacteroidales;f__[Paraprevotellaceae];Other
testkevin480	k__Bacteria;p__Bacteroidetes;c__Bacteroidia;o__Bacteroidales;f__[Paraprevotellaceae];g__Paraprevotella
testkevin481	k__Bacteria;p__Bacteroidetes;c__Bacteroidia;o__Bacteroidales;f__[Paraprevotellaceae];g__YRC22
testkevin482	k__Bacteria;p__Bacteroidetes;c__Bacteroidia;o__Bacteroidales;f__[Paraprevotellaceae];g__[Prevotella]
testkevin483	k__Bacteria;p__Bacteroidetes;c__Cytophagia;o__Cytophagales;f__Cytophagaceae;Other
testkevin484	k__Bacteria;p__Bacteroidetes;c__Cytophagia;o__Cytophagales;f__Cytophagaceae;g__Hymenobacter
testkevin485	k__Bacteria;p__Bacteroidetes;c__Flavobacteriia;o__Flavobacteriales;Other;Other
testkevin486	k__Bacteria;p__Bacteroidetes;c__Flavobacteriia;o__Flavobacteriales;f__Flavobacteriaceae;Other
testkevin487	k__Bacteria;p__Bacteroidetes;c__Flavobacteriia;o__Flavobacteriales;f__Flavobacteriaceae;g__
testkevin488	k__Bacteria;p__Bacteroidetes;c__Flavobacteriia;o__Flavobacteriales;f__[Weeksellaceae];g__
testkevin489	k__Bacteria;p__Bacteroidetes;c__Sphingobacteriia;o__Sphingobacteriales;f__Sphingobacteriaceae;g__Pedobacter
testkevin490	k__Bacteria;p__Bacteroidetes;c__[Saprospirae];o__[Saprospirales];f__Chitinophagaceae;g__
testkevin491	k__Bacteria;p__Bacteroidetes;c__[Saprospirae];o__[Saprospirales];f__Chitinophagaceae;g__Flavisolibacter
testkevin492	k__Bacteria;p__Bacteroidetes;c__[Saprospirae];o__[Saprospirales];f__Chitinophagaceae;g__Sediminibacterium
testkevin493	k__Bacteria;p__Chloroflexi;Other;Other;Other;Other
testkevin494	k__Bacteria;p__Chloroflexi;c__Anaerolineae;Other;Other;Other
testkevin495	k__Bacteria;p__Chloroflexi;c__Anaerolineae;o__CFB-26;f__;g__
testkevin496	k__Bacteria;p__Chloroflexi;c__Anaerolineae;o__OPB11;f__;g__
testkevin497	k__Bacteria;p__Chloroflexi;c__Anaerolineae;o__S0208;f__;g__
testkevin498	k__Bacteria;p__Chloroflexi;c__Anaerolineae;o__SBR1031;f__A4b;g__
testkevin499	k__Bacteria;p__Chloroflexi;c__Anaerolineae;o__SBR1031;f__SJA-101;g__
testkevin500	k__Bacteria;p__Chloroflexi;c__Chloroflexi;o__[Roseiflexales];f__;g__
testkevin501	k__Bacteria;p__Chloroflexi;c__Dehalococcoidetes;o__Dehalococcoidales;f__Dehalococcoidaceae;g__
testkevin502	k__Bacteria;p__Chloroflexi;c__Ktedonobacteria;o__B12-WMSP1;f__;g__
testkevin503	k__Bacteria;p__Chloroflexi;c__SAR202;o__;f__;g__
testkevin504	k__Bacteria;p__Cyanobacteria;Other;Other;Other;Other
testkevin505	k__Bacteria;p__Cyanobacteria;c__4C0d-2;o__MLE1-12;f__;g__
testkevin506	k__Bacteria;p__Cyanobacteria;c__4C0d-2;o__YS2;f__;g__
testkevin507	k__Bacteria;p__Cyanobacteria;c__Chloroplast;o__Chlorophyta;f__;g__
testkevin508	k__Bacteria;p__Cyanobacteria;c__Chloroplast;o__Streptophyta;f__;g__
testkevin509	k__Bacteria;p__Cyanobacteria;c__Nostocophycideae;o__Nostocales;Other;Other
testkevin510	k__Bacteria;p__Cyanobacteria;c__Synechococcophycideae;o__Pseudanabaenales;f__Pseudanabaenaceae;g__Halomicronema
testkevin511	k__Bacteria;p__Firmicutes;Other;Other;Other;Other
testkevin512	k__Bacteria;p__Firmicutes;c__Bacilli;Other;Other;Other
testkevin513	k__Bacteria;p__Firmicutes;c__Bacilli;o__Bacillales;Other;Other
testkevin514	k__Bacteria;p__Firmicutes;c__Bacilli;o__Bacillales;f__Bacillaceae;Other
testkevin515	k__Bacteria;p__Firmicutes;c__Bacilli;o__Bacillales;f__Bacillaceae;g__Bacillus
testkevin516	k__Bacteria;p__Firmicutes;c__Bacilli;o__Bacillales;f__Planococcaceae;g__Solibacillus
testkevin517	k__Bacteria;p__Firmicutes;c__Bacilli;o__Bacillales;f__Staphylococcaceae;Other
testkevin518	k__Bacteria;p__Firmicutes;c__Bacilli;o__Bacillales;f__Staphylococcaceae;g__Staphylococcus
testkevin519	k__Bacteria;p__Firmicutes;c__Bacilli;o__Gemellales;f__Gemellaceae;g__
testkevin520	k__Bacteria;p__Firmicutes;c__Bacilli;o__Gemellales;f__Gemellaceae;g__Gemella
testkevin521	k__Bacteria;p__Firmicutes;c__Bacilli;o__Lactobacillales;Other;Other
testkevin522	k__Bacteria;p__Firmicutes;c__Bacilli;o__Lactobacillales;f__;g__
testkevin523	k__Bacteria;p__Firmicutes;c__Bacilli;o__Lactobacillales;f__Aerococcaceae;g__Abiotrophia
testkevin524	k__Bacteria;p__Firmicutes;c__Bacilli;o__Lactobacillales;f__Aerococcaceae;g__Alloiococcus
testkevin525	k__Bacteria;p__Firmicutes;c__Bacilli;o__Lactobacillales;f__Carnobacteriaceae;g__Granulicatella
testkevin526	k__Bacteria;p__Firmicutes;c__Bacilli;o__Lactobacillales;f__Enterococcaceae;Other
testkevin527	k__Bacteria;p__Firmicutes;c__Bacilli;o__Lactobacillales;f__Enterococcaceae;g__
testkevin528	k__Bacteria;p__Firmicutes;c__Bacilli;o__Lactobacillales;f__Enterococcaceae;g__Enterococcus
testkevin529	k__Bacteria;p__Firmicutes;c__Bacilli;o__Lactobacillales;f__Enterococcaceae;g__Vagococcus
testkevin530	k__Bacteria;p__Firmicutes;c__Bacilli;o__Lactobacillales;f__Lactobacillaceae;Other
testkevin531	k__Bacteria;p__Firmicutes;c__Bacilli;o__Lactobacillales;f__Lactobacillaceae;g__Lactobacillus
testkevin532	k__Bacteria;p__Firmicutes;c__Bacilli;o__Lactobacillales;f__Lactobacillaceae;g__Pediococcus
testkevin533	k__Bacteria;p__Firmicutes;c__Bacilli;o__Lactobacillales;f__Leuconostocaceae;g__
testkevin534	k__Bacteria;p__Firmicutes;c__Bacilli;o__Lactobacillales;f__Leuconostocaceae;g__Fructobacillus
testkevin535	k__Bacteria;p__Firmicutes;c__Bacilli;o__Lactobacillales;f__Leuconostocaceae;g__Leuconostoc
testkevin536	k__Bacteria;p__Firmicutes;c__Bacilli;o__Lactobacillales;f__Leuconostocaceae;g__Weissella
testkevin537	k__Bacteria;p__Firmicutes;c__Bacilli;o__Lactobacillales;f__Streptococcaceae;g__
testkevin538	k__Bacteria;p__Firmicutes;c__Bacilli;o__Lactobacillales;f__Streptococcaceae;g__Lactococcus
testkevin539	k__Bacteria;p__Firmicutes;c__Bacilli;o__Lactobacillales;f__Streptococcaceae;g__Streptococcus
testkevin540	k__Bacteria;p__Firmicutes;c__Bacilli;o__Turicibacterales;f__Turicibacteraceae;g__Turicibacter
testkevin541	k__Bacteria;p__Firmicutes;c__Clostridia;Other;Other;Other
testkevin542	k__Bacteria;p__Firmicutes;c__Clostridia;o__;f__;g__
testkevin543	k__Bacteria;p__Firmicutes;c__Clostridia;o__Clostridiales;Other;Other
testkevin544	k__Bacteria;p__Firmicutes;c__Clostridia;o__Clostridiales;f__;g__
testkevin545	k__Bacteria;p__Firmicutes;c__Clostridia;o__Clostridiales;f__Christensenellaceae;g__
testkevin546	k__Bacteria;p__Firmicutes;c__Clostridia;o__Clostridiales;f__Christensenellaceae;g__Christensenella
testkevin547	k__Bacteria;p__Firmicutes;c__Clostridia;o__Clostridiales;f__Clostridiaceae;Other
testkevin548	k__Bacteria;p__Firmicutes;c__Clostridia;o__Clostridiales;f__Clostridiaceae;g__
testkevin549	k__Bacteria;p__Firmicutes;c__Clostridia;o__Clostridiales;f__Clostridiaceae;g__Clostridium
testkevin550	k__Bacteria;p__Firmicutes;c__Clostridia;o__Clostridiales;f__Clostridiaceae;g__SMB53
testkevin551	k__Bacteria;p__Firmicutes;c__Clostridia;o__Clostridiales;f__Dehalobacteriaceae;g__Dehalobacterium
testkevin552	k__Bacteria;p__Firmicutes;c__Clostridia;o__Clostridiales;f__EtOH8;g__
testkevin553	k__Bacteria;p__Firmicutes;c__Clostridia;o__Clostridiales;f__Eubacteriaceae;g__Anaerofustis
testkevin554	k__Bacteria;p__Firmicutes;c__Clostridia;o__Clostridiales;f__Eubacteriaceae;g__Pseudoramibacter_Eubacterium
testkevin555	k__Bacteria;p__Firmicutes;c__Clostridia;o__Clostridiales;f__Lachnospiraceae;Other
testkevin556	k__Bacteria;p__Firmicutes;c__Clostridia;o__Clostridiales;f__Lachnospiraceae;g__
testkevin557	k__Bacteria;p__Firmicutes;c__Clostridia;o__Clostridiales;f__Lachnospiraceae;g__Anaerostipes
testkevin558	k__Bacteria;p__Firmicutes;c__Clostridia;o__Clostridiales;f__Lachnospiraceae;g__Blautia
testkevin559	k__Bacteria;p__Firmicutes;c__Clostridia;o__Clostridiales;f__Lachnospiraceae;g__Coprococcus
testkevin560	k__Bacteria;p__Firmicutes;c__Clostridia;o__Clostridiales;f__Lachnospiraceae;g__Dorea
testkevin561	k__Bacteria;p__Firmicutes;c__Clostridia;o__Clostridiales;f__Lachnospiraceae;g__Epulopiscium
testkevin562	k__Bacteria;p__Firmicutes;c__Clostridia;o__Clostridiales;f__Lachnospiraceae;g__Lachnospira
testkevin563	k__Bacteria;p__Firmicutes;c__Clostridia;o__Clostridiales;f__Lachnospiraceae;g__Roseburia
testkevin564	k__Bacteria;p__Firmicutes;c__Clostridia;o__Clostridiales;f__Lachnospiraceae;g__[Ruminococcus]
testkevin565	k__Bacteria;p__Firmicutes;c__Clostridia;o__Clostridiales;f__Peptococcaceae;g__
testkevin566	k__Bacteria;p__Firmicutes;c__Clostridia;o__Clostridiales;f__Peptococcaceae;g__Desulfosporosinus
testkevin567	k__Bacteria;p__Firmicutes;c__Clostridia;o__Clostridiales;f__Peptococcaceae;g__Desulfotomaculum
testkevin568	k__Bacteria;p__Firmicutes;c__Clostridia;o__Clostridiales;f__Peptococcaceae;g__Sporotomaculum
testkevin569	k__Bacteria;p__Firmicutes;c__Clostridia;o__Clostridiales;f__Peptococcaceae;g__rc4-4
testkevin570	k__Bacteria;p__Firmicutes;c__Clostridia;o__Clostridiales;f__Peptostreptococcaceae;Other
testkevin571	k__Bacteria;p__Firmicutes;c__Clostridia;o__Clostridiales;f__Peptostreptococcaceae;g__
testkevin572	k__Bacteria;p__Firmicutes;c__Clostridia;o__Clostridiales;f__Peptostreptococcaceae;g__Peptostreptococcus
testkevin573	k__Bacteria;p__Firmicutes;c__Clostridia;o__Clostridiales;f__Ruminococcaceae;Other
testkevin574	k__Bacteria;p__Firmicutes;c__Clostridia;o__Clostridiales;f__Ruminococcaceae;g__
testkevin575	k__Bacteria;p__Firmicutes;c__Clostridia;o__Clostridiales;f__Ruminococcaceae;g__Anaerotruncus
testkevin576	k__Bacteria;p__Firmicutes;c__Clostridia;o__Clostridiales;f__Ruminococcaceae;g__Faecalibacterium
testkevin577	k__Bacteria;p__Firmicutes;c__Clostridia;o__Clostridiales;f__Ruminococcaceae;g__Oscillospira
testkevin578	k__Bacteria;p__Firmicutes;c__Clostridia;o__Clostridiales;f__Ruminococcaceae;g__Ruminococcus
testkevin579	k__Bacteria;p__Firmicutes;c__Clostridia;o__Clostridiales;f__Veillonellaceae;Other
testkevin580	k__Bacteria;p__Firmicutes;c__Clostridia;o__Clostridiales;f__Veillonellaceae;g__
testkevin581	k__Bacteria;p__Firmicutes;c__Clostridia;o__Clostridiales;f__Veillonellaceae;g__Acidaminococcus
testkevin582	k__Bacteria;p__Firmicutes;c__Clostridia;o__Clostridiales;f__Veillonellaceae;g__Dialister
testkevin583	k__Bacteria;p__Firmicutes;c__Clostridia;o__Clostridiales;f__Veillonellaceae;g__Megamonas
testkevin584	k__Bacteria;p__Firmicutes;c__Clostridia;o__Clostridiales;f__Veillonellaceae;g__Megasphaera
testkevin585	k__Bacteria;p__Firmicutes;c__Clostridia;o__Clostridiales;f__Veillonellaceae;g__Mitsuokella
testkevin586	k__Bacteria;p__Firmicutes;c__Clostridia;o__Clostridiales;f__Veillonellaceae;g__Phascolarctobacterium
testkevin587	k__Bacteria;p__Firmicutes;c__Clostridia;o__Clostridiales;f__Veillonellaceae;g__Selenomonas
testkevin588	k__Bacteria;p__Firmicutes;c__Clostridia;o__Clostridiales;f__Veillonellaceae;g__Succiniclasticum
testkevin589	k__Bacteria;p__Firmicutes;c__Clostridia;o__Clostridiales;f__Veillonellaceae;g__Veillonella
testkevin590	k__Bacteria;p__Firmicutes;c__Clostridia;o__Clostridiales;f__[Mogibacteriaceae];g__
testkevin591	k__Bacteria;p__Firmicutes;c__Clostridia;o__Clostridiales;f__[Mogibacteriaceae];g__Mogibacterium
testkevin592	k__Bacteria;p__Firmicutes;c__Clostridia;o__Clostridiales;f__[Tissierellaceae];Other
testkevin593	k__Bacteria;p__Firmicutes;c__Clostridia;o__Clostridiales;f__[Tissierellaceae];g__1-68
testkevin594	k__Bacteria;p__Firmicutes;c__Clostridia;o__Clostridiales;f__[Tissierellaceae];g__Anaerococcus
testkevin595	k__Bacteria;p__Firmicutes;c__Clostridia;o__Clostridiales;f__[Tissierellaceae];g__Finegoldia
testkevin596	k__Bacteria;p__Firmicutes;c__Clostridia;o__Clostridiales;f__[Tissierellaceae];g__Gallicola
testkevin597	k__Bacteria;p__Firmicutes;c__Clostridia;o__Clostridiales;f__[Tissierellaceae];g__Parvimonas
testkevin598	k__Bacteria;p__Firmicutes;c__Clostridia;o__Clostridiales;f__[Tissierellaceae];g__Peptoniphilus
testkevin599	k__Bacteria;p__Firmicutes;c__Clostridia;o__Clostridiales;f__[Tissierellaceae];g__WAL_1855D
testkevin600	k__Bacteria;p__Firmicutes;c__Clostridia;o__SHA-98;f__;g__
testkevin601	k__Bacteria;p__Firmicutes;c__Erysipelotrichi;o__Erysipelotrichales;f__Erysipelotrichaceae;g__
testkevin602	k__Bacteria;p__Firmicutes;c__Erysipelotrichi;o__Erysipelotrichales;f__Erysipelotrichaceae;g__Allobaculum
testkevin603	k__Bacteria;p__Firmicutes;c__Erysipelotrichi;o__Erysipelotrichales;f__Erysipelotrichaceae;g__Bulleidia
testkevin604	k__Bacteria;p__Firmicutes;c__Erysipelotrichi;o__Erysipelotrichales;f__Erysipelotrichaceae;g__Catenibacterium
testkevin605	k__Bacteria;p__Firmicutes;c__Erysipelotrichi;o__Erysipelotrichales;f__Erysipelotrichaceae;g__Coprobacillus
testkevin606	k__Bacteria;p__Firmicutes;c__Erysipelotrichi;o__Erysipelotrichales;f__Erysipelotrichaceae;g__Holdemania
testkevin607	k__Bacteria;p__Firmicutes;c__Erysipelotrichi;o__Erysipelotrichales;f__Erysipelotrichaceae;g__[Eubacterium]
testkevin608	k__Bacteria;p__Firmicutes;c__Erysipelotrichi;o__Erysipelotrichales;f__Erysipelotrichaceae;g__cc_115
testkevin609	k__Bacteria;p__Fusobacteria;c__Fusobacteriia;o__Fusobacteriales;Other;Other
testkevin610	k__Bacteria;p__Fusobacteria;c__Fusobacteriia;o__Fusobacteriales;f__Fusobacteriaceae;Other
testkevin611	k__Bacteria;p__Fusobacteria;c__Fusobacteriia;o__Fusobacteriales;f__Fusobacteriaceae;g__Fusobacterium
testkevin612	k__Bacteria;p__Fusobacteria;c__Fusobacteriia;o__Fusobacteriales;f__Leptotrichiaceae;Other
testkevin613	k__Bacteria;p__Fusobacteria;c__Fusobacteriia;o__Fusobacteriales;f__Leptotrichiaceae;g__Leptotrichia
testkevin614	k__Bacteria;p__GN02;c__3BR-5F;o__;f__;g__
testkevin615	k__Bacteria;p__Gemmatimonadetes;c__Gemm-2;o__;f__;g__
testkevin616	k__Bacteria;p__Gemmatimonadetes;c__Gemm-3;o__;f__;g__
testkevin617	k__Bacteria;p__Gemmatimonadetes;c__Gemm-5;o__;f__;g__
testkevin618	k__Bacteria;p__Gemmatimonadetes;c__Gemmatimonadetes;o__;f__;g__
testkevin619	k__Bacteria;p__Lentisphaerae;c__[Lentisphaeria];o__Victivallales;f__Victivallaceae;g__
testkevin620	k__Bacteria;p__OP1;c__[Acetothermia];o__[Acetothermales];f__;g__
testkevin621	k__Bacteria;p__OP8;c__OP8_2;o__;f__;g__
testkevin622	k__Bacteria;p__Planctomycetes;Other;Other;Other;Other
testkevin623	k__Bacteria;p__Planctomycetes;c__;o__;f__;g__
testkevin624	k__Bacteria;p__Planctomycetes;c__OM190;o__agg27;f__;g__
testkevin625	k__Bacteria;p__Planctomycetes;c__Phycisphaerae;Other;Other;Other
testkevin626	k__Bacteria;p__Planctomycetes;c__Phycisphaerae;o__Phycisphaerales;f__;g__
testkevin627	k__Bacteria;p__Planctomycetes;c__Phycisphaerae;o__mle1-8;f__;g__
testkevin628	k__Bacteria;p__Proteobacteria;Other;Other;Other;Other
testkevin629	k__Bacteria;p__Proteobacteria;c__Alphaproteobacteria;Other;Other;Other
testkevin630	k__Bacteria;p__Proteobacteria;c__Alphaproteobacteria;o__Caulobacterales;f__Caulobacteraceae;g__
testkevin631	k__Bacteria;p__Proteobacteria;c__Alphaproteobacteria;o__RF32;f__;g__
testkevin632	k__Bacteria;p__Proteobacteria;c__Alphaproteobacteria;o__Rhizobiales;Other;Other
testkevin633	k__Bacteria;p__Proteobacteria;c__Alphaproteobacteria;o__Rhizobiales;f__;g__
testkevin634	k__Bacteria;p__Proteobacteria;c__Alphaproteobacteria;o__Rhizobiales;f__Beijerinckiaceae;g__
testkevin635	k__Bacteria;p__Proteobacteria;c__Alphaproteobacteria;o__Rhizobiales;f__Bradyrhizobiaceae;g__
testkevin636	k__Bacteria;p__Proteobacteria;c__Alphaproteobacteria;o__Rhizobiales;f__Hyphomicrobiaceae;g__Hyphomicrobium
testkevin637	k__Bacteria;p__Proteobacteria;c__Alphaproteobacteria;o__Rhizobiales;f__Hyphomicrobiaceae;g__Rhodoplanes
testkevin638	k__Bacteria;p__Proteobacteria;c__Alphaproteobacteria;o__Rhizobiales;f__Methylobacteriaceae;g__
testkevin639	k__Bacteria;p__Proteobacteria;c__Alphaproteobacteria;o__Rhizobiales;f__Phyllobacteriaceae;Other
testkevin640	k__Bacteria;p__Proteobacteria;c__Alphaproteobacteria;o__Rhizobiales;f__Phyllobacteriaceae;g__
testkevin641	k__Bacteria;p__Proteobacteria;c__Alphaproteobacteria;o__Rhodobacterales;f__Rhodobacteraceae;Other
testkevin642	k__Bacteria;p__Proteobacteria;c__Alphaproteobacteria;o__Rhodobacterales;f__Rhodobacteraceae;g__
testkevin643	k__Bacteria;p__Proteobacteria;c__Alphaproteobacteria;o__Rhodobacterales;f__Rhodobacteraceae;g__Paracoccus
testkevin644	k__Bacteria;p__Proteobacteria;c__Alphaproteobacteria;o__Sphingomonadales;f__Sphingomonadaceae;Other
testkevin645	k__Bacteria;p__Proteobacteria;c__Alphaproteobacteria;o__Sphingomonadales;f__Sphingomonadaceae;g__
testkevin646	k__Bacteria;p__Proteobacteria;c__Alphaproteobacteria;o__Sphingomonadales;f__Sphingomonadaceae;g__Sphingomonas
testkevin647	k__Bacteria;p__Proteobacteria;c__Alphaproteobacteria;o__Sphingomonadales;f__Sphingomonadaceae;g__Sphingopyxis
testkevin648	k__Bacteria;p__Proteobacteria;c__Betaproteobacteria;Other;Other;Other
testkevin649	k__Bacteria;p__Proteobacteria;c__Betaproteobacteria;o__;f__;g__
testkevin650	k__Bacteria;p__Proteobacteria;c__Betaproteobacteria;o__Burkholderiales;Other;Other
testkevin651	k__Bacteria;p__Proteobacteria;c__Betaproteobacteria;o__Burkholderiales;f__Alcaligenaceae;g__
testkevin652	k__Bacteria;p__Proteobacteria;c__Betaproteobacteria;o__Burkholderiales;f__Alcaligenaceae;g__Sutterella
testkevin653	k__Bacteria;p__Proteobacteria;c__Betaproteobacteria;o__Burkholderiales;f__Burkholderiaceae;g__Burkholderia
testkevin654	k__Bacteria;p__Proteobacteria;c__Betaproteobacteria;o__Burkholderiales;f__Comamonadaceae;Other
testkevin655	k__Bacteria;p__Proteobacteria;c__Betaproteobacteria;o__Burkholderiales;f__Comamonadaceae;g__
testkevin656	k__Bacteria;p__Proteobacteria;c__Betaproteobacteria;o__Burkholderiales;f__Comamonadaceae;g__Comamonas
testkevin657	k__Bacteria;p__Proteobacteria;c__Betaproteobacteria;o__Burkholderiales;f__Comamonadaceae;g__Delftia
testkevin658	k__Bacteria;p__Proteobacteria;c__Betaproteobacteria;o__Burkholderiales;f__Oxalobacteraceae;g__
testkevin659	k__Bacteria;p__Proteobacteria;c__Betaproteobacteria;o__Burkholderiales;f__Oxalobacteraceae;g__Cupriavidus
testkevin660	k__Bacteria;p__Proteobacteria;c__Betaproteobacteria;o__Burkholderiales;f__Oxalobacteraceae;g__Oxalobacter
testkevin661	k__Bacteria;p__Proteobacteria;c__Betaproteobacteria;o__Burkholderiales;f__Oxalobacteraceae;g__Ralstonia
testkevin662	k__Bacteria;p__Proteobacteria;c__Betaproteobacteria;o__Gallionellales;f__Gallionellaceae;g__Gallionella
testkevin663	k__Bacteria;p__Proteobacteria;c__Betaproteobacteria;o__Methylophilales;f__Methylophilaceae;g__
testkevin664	k__Bacteria;p__Proteobacteria;c__Betaproteobacteria;o__Methylophilales;f__Methylophilaceae;g__Methylotenera
testkevin665	k__Bacteria;p__Proteobacteria;c__Betaproteobacteria;o__Neisseriales;f__Neisseriaceae;Other
testkevin666	k__Bacteria;p__Proteobacteria;c__Betaproteobacteria;o__Neisseriales;f__Neisseriaceae;g__
testkevin667	k__Bacteria;p__Proteobacteria;c__Betaproteobacteria;o__Neisseriales;f__Neisseriaceae;g__Eikenella
testkevin668	k__Bacteria;p__Proteobacteria;c__Betaproteobacteria;o__Rhodocyclales;f__Rhodocyclaceae;g__
testkevin669	k__Bacteria;p__Proteobacteria;c__Betaproteobacteria;o__Rhodocyclales;f__Rhodocyclaceae;g__Propionivibrio
testkevin670	k__Bacteria;p__Proteobacteria;c__Deltaproteobacteria;Other;Other;Other
testkevin671	k__Bacteria;p__Proteobacteria;c__Deltaproteobacteria;o__;f__;g__
testkevin672	k__Bacteria;p__Proteobacteria;c__Deltaproteobacteria;o__Desulfobacterales;f__Desulfobulbaceae;g__
testkevin673	k__Bacteria;p__Proteobacteria;c__Deltaproteobacteria;o__Desulfovibrionales;f__Desulfovibrionaceae;Other
testkevin674	k__Bacteria;p__Proteobacteria;c__Deltaproteobacteria;o__Desulfovibrionales;f__Desulfovibrionaceae;g__Bilophila
testkevin675	k__Bacteria;p__Proteobacteria;c__Deltaproteobacteria;o__Desulfovibrionales;f__Desulfovibrionaceae;g__Desulfovibrio
testkevin676	k__Bacteria;p__Proteobacteria;c__Deltaproteobacteria;o__Desulfovibrionales;f__Desulfovibrionaceae;g__Lawsonia
testkevin677	k__Bacteria;p__Proteobacteria;c__Deltaproteobacteria;o__Myxococcales;Other;Other
testkevin678	k__Bacteria;p__Proteobacteria;c__Deltaproteobacteria;o__Myxococcales;f__;g__
testkevin679	k__Bacteria;p__Proteobacteria;c__Deltaproteobacteria;o__Myxococcales;f__Haliangiaceae;g__
testkevin680	k__Bacteria;p__Proteobacteria;c__Deltaproteobacteria;o__PB19;f__;g__
testkevin681	k__Bacteria;p__Proteobacteria;c__Deltaproteobacteria;o__Syntrophobacterales;f__Syntrophobacteraceae;g__Syntrophobacter
testkevin682	k__Bacteria;p__Proteobacteria;c__Deltaproteobacteria;o__Thermodesulfobacteriales;f__;g__
testkevin683	k__Bacteria;p__Proteobacteria;c__Epsilonproteobacteria;o__Campylobacterales;f__Campylobacteraceae;g__Campylobacter
testkevin684	k__Bacteria;p__Proteobacteria;c__Gammaproteobacteria;Other;Other;Other
testkevin685	k__Bacteria;p__Proteobacteria;c__Gammaproteobacteria;o__Aeromonadales;f__Aeromonadaceae;g__
testkevin686	k__Bacteria;p__Proteobacteria;c__Gammaproteobacteria;o__Alteromonadales;Other;Other
testkevin687	k__Bacteria;p__Proteobacteria;c__Gammaproteobacteria;o__Alteromonadales;f__Alteromonadaceae;Other
testkevin688	k__Bacteria;p__Proteobacteria;c__Gammaproteobacteria;o__Alteromonadales;f__Alteromonadaceae;g__Glaciecola
testkevin689	k__Bacteria;p__Proteobacteria;c__Gammaproteobacteria;o__Cardiobacteriales;f__Cardiobacteriaceae;g__Cardiobacterium
testkevin690	k__Bacteria;p__Proteobacteria;c__Gammaproteobacteria;o__Enterobacteriales;f__Enterobacteriaceae;Other
testkevin691	k__Bacteria;p__Proteobacteria;c__Gammaproteobacteria;o__Enterobacteriales;f__Enterobacteriaceae;g__
testkevin692	k__Bacteria;p__Proteobacteria;c__Gammaproteobacteria;o__Enterobacteriales;f__Enterobacteriaceae;g__Citrobacter
testkevin693	k__Bacteria;p__Proteobacteria;c__Gammaproteobacteria;o__Enterobacteriales;f__Enterobacteriaceae;g__Enterobacter
testkevin694	k__Bacteria;p__Proteobacteria;c__Gammaproteobacteria;o__Enterobacteriales;f__Enterobacteriaceae;g__Gluconacetobacter
testkevin695	k__Bacteria;p__Proteobacteria;c__Gammaproteobacteria;o__Enterobacteriales;f__Enterobacteriaceae;g__Morganella
testkevin696	k__Bacteria;p__Proteobacteria;c__Gammaproteobacteria;o__Enterobacteriales;f__Enterobacteriaceae;g__Proteus
testkevin697	k__Bacteria;p__Proteobacteria;c__Gammaproteobacteria;o__Enterobacteriales;f__Enterobacteriaceae;g__Providencia
testkevin698	k__Bacteria;p__Proteobacteria;c__Gammaproteobacteria;o__Enterobacteriales;f__Enterobacteriaceae;g__Serratia
testkevin699	k__Bacteria;p__Proteobacteria;c__Gammaproteobacteria;o__Legionellales;f__Coxiellaceae;g__
testkevin700	k__Bacteria;p__Proteobacteria;c__Gammaproteobacteria;o__Legionellales;f__Francisellaceae;g__
testkevin701	k__Bacteria;p__Proteobacteria;c__Gammaproteobacteria;o__Oceanospirillales;f__Oceanospirillaceae;g__Marinobacterium
testkevin702	k__Bacteria;p__Proteobacteria;c__Gammaproteobacteria;o__Pasteurellales;f__Pasteurellaceae;Other
testkevin703	k__Bacteria;p__Proteobacteria;c__Gammaproteobacteria;o__Pasteurellales;f__Pasteurellaceae;g__Actinobacillus
testkevin704	k__Bacteria;p__Proteobacteria;c__Gammaproteobacteria;o__Pasteurellales;f__Pasteurellaceae;g__Aggregatibacter
testkevin705	k__Bacteria;p__Proteobacteria;c__Gammaproteobacteria;o__Pasteurellales;f__Pasteurellaceae;g__Haemophilus
testkevin706	k__Bacteria;p__Proteobacteria;c__Gammaproteobacteria;o__Pasteurellales;f__Pasteurellaceae;g__Pasteurella
testkevin707	k__Bacteria;p__Proteobacteria;c__Gammaproteobacteria;o__Pseudomonadales;Other;Other
testkevin708	k__Bacteria;p__Proteobacteria;c__Gammaproteobacteria;o__Pseudomonadales;f__Moraxellaceae;Other
testkevin709	k__Bacteria;p__Proteobacteria;c__Gammaproteobacteria;o__Pseudomonadales;f__Moraxellaceae;g__
testkevin710	k__Bacteria;p__Proteobacteria;c__Gammaproteobacteria;o__Pseudomonadales;f__Moraxellaceae;g__Acinetobacter
testkevin711	k__Bacteria;p__Proteobacteria;c__Gammaproteobacteria;o__Pseudomonadales;f__Moraxellaceae;g__Perlucidibaca
testkevin712	k__Bacteria;p__Proteobacteria;c__Gammaproteobacteria;o__Pseudomonadales;f__Moraxellaceae;g__Psychrobacter
testkevin713	k__Bacteria;p__Proteobacteria;c__Gammaproteobacteria;o__Pseudomonadales;f__Pseudomonadaceae;Other
testkevin714	k__Bacteria;p__Proteobacteria;c__Gammaproteobacteria;o__Pseudomonadales;f__Pseudomonadaceae;g__Pseudomonas
testkevin715	k__Bacteria;p__Proteobacteria;c__Gammaproteobacteria;o__Thiotrichales;f__Piscirickettsiaceae;g__
testkevin716	k__Bacteria;p__Proteobacteria;c__Gammaproteobacteria;o__Vibrionales;f__Pseudoalteromonadaceae;g__
testkevin717	k__Bacteria;p__Proteobacteria;c__Gammaproteobacteria;o__Vibrionales;f__Pseudoalteromonadaceae;g__Pseudoalteromonas
testkevin718	k__Bacteria;p__Proteobacteria;c__Gammaproteobacteria;o__Vibrionales;f__Vibrionaceae;Other
testkevin719	k__Bacteria;p__Proteobacteria;c__Gammaproteobacteria;o__Xanthomonadales;f__Sinobacteraceae;g__
testkevin720	k__Bacteria;p__Proteobacteria;c__Gammaproteobacteria;o__Xanthomonadales;f__Xanthomonadaceae;g__
testkevin721	k__Bacteria;p__SAR406;c__AB16;o__;f__;g__
testkevin722	k__Bacteria;p__SAR406;c__AB16;o__SSW63Au;f__SHAS460;g__
testkevin723	k__Bacteria;p__SR1;c__;o__;f__;g__
testkevin724	k__Bacteria;p__Synergistetes;c__Synergistia;o__Synergistales;f__Dethiosulfovibrionaceae;g__Pyramidobacter
testkevin725	k__Bacteria;p__Synergistetes;c__Synergistia;o__Synergistales;f__Dethiosulfovibrionaceae;g__TG5
testkevin726	k__Bacteria;p__TM7;c__TM7-3;o__;f__;g__
testkevin727	k__Bacteria;p__TM7;c__TM7-3;o__CW040;f__;g__
testkevin728	k__Bacteria;p__TM7;c__TM7-3;o__CW040;f__F16;g__
testkevin729	k__Bacteria;p__Tenericutes;c__Mollicutes;o__RF39;f__;g__
testkevin730	k__Bacteria;p__Tenericutes;c__RF3;o__ML615J-28;f__;g__
testkevin731	k__Bacteria;p__Verrucomicrobia;Other;Other;Other;Other
testkevin732	k__Bacteria;p__Verrucomicrobia;c__Opitutae;o__Puniceicoccales;f__Puniceicoccaceae;g__Puniceicoccus
testkevin733	k__Bacteria;p__Verrucomicrobia;c__Opitutae;o__[Cerasicoccales];f__[Cerasicoccaceae];g__
testkevin734	k__Bacteria;p__Verrucomicrobia;c__Verrucomicrobiae;o__Verrucomicrobiales;f__Verrucomicrobiaceae;Other
testkevin735	k__Bacteria;p__Verrucomicrobia;c__Verrucomicrobiae;o__Verrucomicrobiales;f__Verrucomicrobiaceae;g__Akkermansia
testkevin736	k__Bacteria;p__WS3;c__PRR-12;o__Sediment-1;f__;g__
testkevin737	k__Bacteria;p__[Thermi];c__Deinococci;o__Deinococcales;f__Deinococcaceae;g__Deinococcus
