testkevinmerged0	Unassigned;Other
testkevinmerged1	k__Archaea;Other
testkevinmerged2	k__Archaea;p__Crenarchaeota
testkevinmerged3	k__Archaea;p__Euryarchaeota
testkevinmerged4	k__Bacteria;Other
testkevinmerged5	k__Bacteria;p__Acidobacteria
testkevinmerged6	k__Bacteria;p__Actinobacteria
testkevinmerged7	k__Bacteria;p__Bacteroidetes
testkevinmerged8	k__Bacteria;p__Chloroflexi
testkevinmerged9	k__Bacteria;p__Cyanobacteria
testkevinmerged10	k__Bacteria;p__Firmicutes
testkevinmerged11	k__Bacteria;p__Fusobacteria
testkevinmerged12	k__Bacteria;p__GN02
testkevinmerged13	k__Bacteria;p__Gemmatimonadetes
testkevinmerged14	k__Bacteria;p__Lentisphaerae
testkevinmerged15	k__Bacteria;p__OP1
testkevinmerged16	k__Bacteria;p__OP8
testkevinmerged17	k__Bacteria;p__Planctomycetes
testkevinmerged18	k__Bacteria;p__Proteobacteria
testkevinmerged19	k__Bacteria;p__SAR406
testkevinmerged20	k__Bacteria;p__SR1
testkevinmerged21	k__Bacteria;p__Synergistetes
testkevinmerged22	k__Bacteria;p__TM7
testkevinmerged23	k__Bacteria;p__Tenericutes
testkevinmerged24	k__Bacteria;p__Verrucomicrobia
testkevinmerged25	k__Bacteria;p__WS3
testkevinmerged26	k__Bacteria;p__[Thermi]
testkevinmerged27	Unassigned;Other;Other
testkevinmerged28	k__Archaea;Other;Other
testkevinmerged29	k__Archaea;p__Crenarchaeota;Other
testkevinmerged30	k__Archaea;p__Crenarchaeota;c__MBGA
testkevinmerged31	k__Archaea;p__Crenarchaeota;c__MCG
testkevinmerged32	k__Archaea;p__Crenarchaeota;c__Thaumarchaeota
testkevinmerged33	k__Archaea;p__Crenarchaeota;c__Thermoprotei
testkevinmerged34	k__Archaea;p__Euryarchaeota;Other
testkevinmerged35	k__Archaea;p__Euryarchaeota;c__ANME-1
testkevinmerged36	k__Archaea;p__Euryarchaeota;c__DSEG
testkevinmerged37	k__Archaea;p__Euryarchaeota;c__Halobacteria
testkevinmerged38	k__Archaea;p__Euryarchaeota;c__Methanomicrobia
testkevinmerged39	k__Archaea;p__Euryarchaeota;c__Thermoplasmata
testkevinmerged40	k__Bacteria;Other;Other
testkevinmerged41	k__Bacteria;p__Acidobacteria;c__Acidobacteria-6
testkevinmerged42	k__Bacteria;p__Actinobacteria;Other
testkevinmerged43	k__Bacteria;p__Actinobacteria;c__Acidimicrobiia
testkevinmerged44	k__Bacteria;p__Actinobacteria;c__Actinobacteria
testkevinmerged45	k__Bacteria;p__Actinobacteria;c__Coriobacteriia
testkevinmerged46	k__Bacteria;p__Actinobacteria;c__OPB41
testkevinmerged47	k__Bacteria;p__Actinobacteria;c__Thermoleophilia
testkevinmerged48	k__Bacteria;p__Bacteroidetes;Other
testkevinmerged49	k__Bacteria;p__Bacteroidetes;c__Bacteroidia
testkevinmerged50	k__Bacteria;p__Bacteroidetes;c__Cytophagia
testkevinmerged51	k__Bacteria;p__Bacteroidetes;c__Flavobacteriia
testkevinmerged52	k__Bacteria;p__Bacteroidetes;c__Sphingobacteriia
testkevinmerged53	k__Bacteria;p__Bacteroidetes;c__[Saprospirae]
testkevinmerged54	k__Bacteria;p__Chloroflexi;Other
testkevinmerged55	k__Bacteria;p__Chloroflexi;c__Anaerolineae
testkevinmerged56	k__Bacteria;p__Chloroflexi;c__Chloroflexi
testkevinmerged57	k__Bacteria;p__Chloroflexi;c__Dehalococcoidetes
testkevinmerged58	k__Bacteria;p__Chloroflexi;c__Ktedonobacteria
testkevinmerged59	k__Bacteria;p__Chloroflexi;c__SAR202
testkevinmerged60	k__Bacteria;p__Cyanobacteria;Other
testkevinmerged61	k__Bacteria;p__Cyanobacteria;c__4C0d-2
testkevinmerged62	k__Bacteria;p__Cyanobacteria;c__Chloroplast
testkevinmerged63	k__Bacteria;p__Cyanobacteria;c__Nostocophycideae
testkevinmerged64	k__Bacteria;p__Cyanobacteria;c__Synechococcophycideae
testkevinmerged65	k__Bacteria;p__Firmicutes;Other
testkevinmerged66	k__Bacteria;p__Firmicutes;c__Bacilli
testkevinmerged67	k__Bacteria;p__Firmicutes;c__Clostridia
testkevinmerged68	k__Bacteria;p__Firmicutes;c__Erysipelotrichi
testkevinmerged69	k__Bacteria;p__Fusobacteria;c__Fusobacteriia
testkevinmerged70	k__Bacteria;p__GN02;c__3BR-5F
testkevinmerged71	k__Bacteria;p__Gemmatimonadetes;c__Gemm-2
testkevinmerged72	k__Bacteria;p__Gemmatimonadetes;c__Gemm-3
testkevinmerged73	k__Bacteria;p__Gemmatimonadetes;c__Gemm-5
testkevinmerged74	k__Bacteria;p__Gemmatimonadetes;c__Gemmatimonadetes
testkevinmerged75	k__Bacteria;p__Lentisphaerae;c__[Lentisphaeria]
testkevinmerged76	k__Bacteria;p__OP1;c__[Acetothermia]
testkevinmerged77	k__Bacteria;p__OP8;c__OP8_2
testkevinmerged78	k__Bacteria;p__Planctomycetes;Other
testkevinmerged79	k__Bacteria;p__Planctomycetes;c__
testkevinmerged80	k__Bacteria;p__Planctomycetes;c__OM190
testkevinmerged81	k__Bacteria;p__Planctomycetes;c__Phycisphaerae
testkevinmerged82	k__Bacteria;p__Proteobacteria;Other
testkevinmerged83	k__Bacteria;p__Proteobacteria;c__Alphaproteobacteria
testkevinmerged84	k__Bacteria;p__Proteobacteria;c__Betaproteobacteria
testkevinmerged85	k__Bacteria;p__Proteobacteria;c__Deltaproteobacteria
testkevinmerged86	k__Bacteria;p__Proteobacteria;c__Epsilonproteobacteria
testkevinmerged87	k__Bacteria;p__Proteobacteria;c__Gammaproteobacteria
testkevinmerged88	k__Bacteria;p__SAR406;c__AB16
testkevinmerged89	k__Bacteria;p__SR1;c__
testkevinmerged90	k__Bacteria;p__Synergistetes;c__Synergistia
testkevinmerged91	k__Bacteria;p__TM7;c__TM7-3
testkevinmerged92	k__Bacteria;p__Tenericutes;c__Mollicutes
testkevinmerged93	k__Bacteria;p__Tenericutes;c__RF3
testkevinmerged94	k__Bacteria;p__Verrucomicrobia;Other
testkevinmerged95	k__Bacteria;p__Verrucomicrobia;c__Opitutae
testkevinmerged96	k__Bacteria;p__Verrucomicrobia;c__Verrucomicrobiae
testkevinmerged97	k__Bacteria;p__WS3;c__PRR-12
testkevinmerged98	k__Bacteria;p__[Thermi];c__Deinococci
testkevinmerged99	Unassigned;Other;Other;Other
testkevinmerged100	k__Archaea;Other;Other;Other
testkevinmerged101	k__Archaea;p__Crenarchaeota;Other;Other
testkevinmerged102	k__Archaea;p__Crenarchaeota;c__MBGA;o__NRP-J
testkevinmerged103	k__Archaea;p__Crenarchaeota;c__MCG;o__pGrfC26
testkevinmerged104	k__Archaea;p__Crenarchaeota;c__Thaumarchaeota;o__Cenarchaeales
testkevinmerged105	k__Archaea;p__Crenarchaeota;c__Thermoprotei;o__Desulfurococcales
testkevinmerged106	k__Archaea;p__Crenarchaeota;c__Thermoprotei;o__Thermoproteales
testkevinmerged107	k__Archaea;p__Euryarchaeota;Other;Other
testkevinmerged108	k__Archaea;p__Euryarchaeota;c__ANME-1;o__
testkevinmerged109	k__Archaea;p__Euryarchaeota;c__DSEG;o__DHVE3
testkevinmerged110	k__Archaea;p__Euryarchaeota;c__Halobacteria;o__Halobacteriales
testkevinmerged111	k__Archaea;p__Euryarchaeota;c__Methanomicrobia;o__Methanomicrobiales
testkevinmerged112	k__Archaea;p__Euryarchaeota;c__Methanomicrobia;o__Methanosarcinales
testkevinmerged113	k__Archaea;p__Euryarchaeota;c__Thermoplasmata;o__Thermoplasmatales
testkevinmerged114	k__Bacteria;Other;Other;Other
testkevinmerged115	k__Bacteria;p__Acidobacteria;c__Acidobacteria-6;Other
testkevinmerged116	k__Bacteria;p__Actinobacteria;Other;Other
testkevinmerged117	k__Bacteria;p__Actinobacteria;c__Acidimicrobiia;o__Acidimicrobiales
testkevinmerged118	k__Bacteria;p__Actinobacteria;c__Actinobacteria;o__Actinomycetales
testkevinmerged119	k__Bacteria;p__Actinobacteria;c__Actinobacteria;o__Bifidobacteriales
testkevinmerged120	k__Bacteria;p__Actinobacteria;c__Coriobacteriia;o__Coriobacteriales
testkevinmerged121	k__Bacteria;p__Actinobacteria;c__OPB41;o__
testkevinmerged122	k__Bacteria;p__Actinobacteria;c__Thermoleophilia;Other
testkevinmerged123	k__Bacteria;p__Actinobacteria;c__Thermoleophilia;o__Solirubrobacterales
testkevinmerged124	k__Bacteria;p__Bacteroidetes;Other;Other
testkevinmerged125	k__Bacteria;p__Bacteroidetes;c__Bacteroidia;o__Bacteroidales
testkevinmerged126	k__Bacteria;p__Bacteroidetes;c__Cytophagia;o__Cytophagales
testkevinmerged127	k__Bacteria;p__Bacteroidetes;c__Flavobacteriia;o__Flavobacteriales
testkevinmerged128	k__Bacteria;p__Bacteroidetes;c__Sphingobacteriia;o__Sphingobacteriales
testkevinmerged129	k__Bacteria;p__Bacteroidetes;c__[Saprospirae];o__[Saprospirales]
testkevinmerged130	k__Bacteria;p__Chloroflexi;Other;Other
testkevinmerged131	k__Bacteria;p__Chloroflexi;c__Anaerolineae;Other
testkevinmerged132	k__Bacteria;p__Chloroflexi;c__Anaerolineae;o__CFB-26
testkevinmerged133	k__Bacteria;p__Chloroflexi;c__Anaerolineae;o__OPB11
testkevinmerged134	k__Bacteria;p__Chloroflexi;c__Anaerolineae;o__S0208
testkevinmerged135	k__Bacteria;p__Chloroflexi;c__Anaerolineae;o__SBR1031
testkevinmerged136	k__Bacteria;p__Chloroflexi;c__Chloroflexi;o__[Roseiflexales]
testkevinmerged137	k__Bacteria;p__Chloroflexi;c__Dehalococcoidetes;o__Dehalococcoidales
testkevinmerged138	k__Bacteria;p__Chloroflexi;c__Ktedonobacteria;o__B12-WMSP1
testkevinmerged139	k__Bacteria;p__Chloroflexi;c__SAR202;o__
testkevinmerged140	k__Bacteria;p__Cyanobacteria;Other;Other
testkevinmerged141	k__Bacteria;p__Cyanobacteria;c__4C0d-2;o__MLE1-12
testkevinmerged142	k__Bacteria;p__Cyanobacteria;c__4C0d-2;o__YS2
testkevinmerged143	k__Bacteria;p__Cyanobacteria;c__Chloroplast;o__Chlorophyta
testkevinmerged144	k__Bacteria;p__Cyanobacteria;c__Chloroplast;o__Streptophyta
testkevinmerged145	k__Bacteria;p__Cyanobacteria;c__Nostocophycideae;o__Nostocales
testkevinmerged146	k__Bacteria;p__Cyanobacteria;c__Synechococcophycideae;o__Pseudanabaenales
testkevinmerged147	k__Bacteria;p__Firmicutes;Other;Other
testkevinmerged148	k__Bacteria;p__Firmicutes;c__Bacilli;Other
testkevinmerged149	k__Bacteria;p__Firmicutes;c__Bacilli;o__Bacillales
testkevinmerged150	k__Bacteria;p__Firmicutes;c__Bacilli;o__Gemellales
testkevinmerged151	k__Bacteria;p__Firmicutes;c__Bacilli;o__Lactobacillales
testkevinmerged152	k__Bacteria;p__Firmicutes;c__Bacilli;o__Turicibacterales
testkevinmerged153	k__Bacteria;p__Firmicutes;c__Clostridia;Other
testkevinmerged154	k__Bacteria;p__Firmicutes;c__Clostridia;o__
testkevinmerged155	k__Bacteria;p__Firmicutes;c__Clostridia;o__Clostridiales
testkevinmerged156	k__Bacteria;p__Firmicutes;c__Clostridia;o__SHA-98
testkevinmerged157	k__Bacteria;p__Firmicutes;c__Erysipelotrichi;o__Erysipelotrichales
testkevinmerged158	k__Bacteria;p__Fusobacteria;c__Fusobacteriia;o__Fusobacteriales
testkevinmerged159	k__Bacteria;p__GN02;c__3BR-5F;o__
testkevinmerged160	k__Bacteria;p__Gemmatimonadetes;c__Gemm-2;o__
testkevinmerged161	k__Bacteria;p__Gemmatimonadetes;c__Gemm-3;o__
testkevinmerged162	k__Bacteria;p__Gemmatimonadetes;c__Gemm-5;o__
testkevinmerged163	k__Bacteria;p__Gemmatimonadetes;c__Gemmatimonadetes;o__
testkevinmerged164	k__Bacteria;p__Lentisphaerae;c__[Lentisphaeria];o__Victivallales
testkevinmerged165	k__Bacteria;p__OP1;c__[Acetothermia];o__[Acetothermales]
testkevinmerged166	k__Bacteria;p__OP8;c__OP8_2;o__
testkevinmerged167	k__Bacteria;p__Planctomycetes;Other;Other
testkevinmerged168	k__Bacteria;p__Planctomycetes;c__;o__
testkevinmerged169	k__Bacteria;p__Planctomycetes;c__OM190;o__agg27
testkevinmerged170	k__Bacteria;p__Planctomycetes;c__Phycisphaerae;Other
testkevinmerged171	k__Bacteria;p__Planctomycetes;c__Phycisphaerae;o__Phycisphaerales
testkevinmerged172	k__Bacteria;p__Planctomycetes;c__Phycisphaerae;o__mle1-8
testkevinmerged173	k__Bacteria;p__Proteobacteria;Other;Other
testkevinmerged174	k__Bacteria;p__Proteobacteria;c__Alphaproteobacteria;Other
testkevinmerged175	k__Bacteria;p__Proteobacteria;c__Alphaproteobacteria;o__Caulobacterales
testkevinmerged176	k__Bacteria;p__Proteobacteria;c__Alphaproteobacteria;o__RF32
testkevinmerged177	k__Bacteria;p__Proteobacteria;c__Alphaproteobacteria;o__Rhizobiales
testkevinmerged178	k__Bacteria;p__Proteobacteria;c__Alphaproteobacteria;o__Rhodobacterales
testkevinmerged179	k__Bacteria;p__Proteobacteria;c__Alphaproteobacteria;o__Sphingomonadales
testkevinmerged180	k__Bacteria;p__Proteobacteria;c__Betaproteobacteria;Other
testkevinmerged181	k__Bacteria;p__Proteobacteria;c__Betaproteobacteria;o__
testkevinmerged182	k__Bacteria;p__Proteobacteria;c__Betaproteobacteria;o__Burkholderiales
testkevinmerged183	k__Bacteria;p__Proteobacteria;c__Betaproteobacteria;o__Gallionellales
testkevinmerged184	k__Bacteria;p__Proteobacteria;c__Betaproteobacteria;o__Methylophilales
testkevinmerged185	k__Bacteria;p__Proteobacteria;c__Betaproteobacteria;o__Neisseriales
testkevinmerged186	k__Bacteria;p__Proteobacteria;c__Betaproteobacteria;o__Rhodocyclales
testkevinmerged187	k__Bacteria;p__Proteobacteria;c__Deltaproteobacteria;Other
testkevinmerged188	k__Bacteria;p__Proteobacteria;c__Deltaproteobacteria;o__
testkevinmerged189	k__Bacteria;p__Proteobacteria;c__Deltaproteobacteria;o__Desulfobacterales
testkevinmerged190	k__Bacteria;p__Proteobacteria;c__Deltaproteobacteria;o__Desulfovibrionales
testkevinmerged191	k__Bacteria;p__Proteobacteria;c__Deltaproteobacteria;o__Myxococcales
testkevinmerged192	k__Bacteria;p__Proteobacteria;c__Deltaproteobacteria;o__PB19
testkevinmerged193	k__Bacteria;p__Proteobacteria;c__Deltaproteobacteria;o__Syntrophobacterales
testkevinmerged194	k__Bacteria;p__Proteobacteria;c__Deltaproteobacteria;o__Thermodesulfobacteriales
testkevinmerged195	k__Bacteria;p__Proteobacteria;c__Epsilonproteobacteria;o__Campylobacterales
testkevinmerged196	k__Bacteria;p__Proteobacteria;c__Gammaproteobacteria;Other
testkevinmerged197	k__Bacteria;p__Proteobacteria;c__Gammaproteobacteria;o__Aeromonadales
testkevinmerged198	k__Bacteria;p__Proteobacteria;c__Gammaproteobacteria;o__Alteromonadales
testkevinmerged199	k__Bacteria;p__Proteobacteria;c__Gammaproteobacteria;o__Cardiobacteriales
testkevinmerged200	k__Bacteria;p__Proteobacteria;c__Gammaproteobacteria;o__Enterobacteriales
testkevinmerged201	k__Bacteria;p__Proteobacteria;c__Gammaproteobacteria;o__Legionellales
testkevinmerged202	k__Bacteria;p__Proteobacteria;c__Gammaproteobacteria;o__Oceanospirillales
testkevinmerged203	k__Bacteria;p__Proteobacteria;c__Gammaproteobacteria;o__Pasteurellales
testkevinmerged204	k__Bacteria;p__Proteobacteria;c__Gammaproteobacteria;o__Pseudomonadales
testkevinmerged205	k__Bacteria;p__Proteobacteria;c__Gammaproteobacteria;o__Thiotrichales
testkevinmerged206	k__Bacteria;p__Proteobacteria;c__Gammaproteobacteria;o__Vibrionales
testkevinmerged207	k__Bacteria;p__Proteobacteria;c__Gammaproteobacteria;o__Xanthomonadales
testkevinmerged208	k__Bacteria;p__SAR406;c__AB16;o__
testkevinmerged209	k__Bacteria;p__SAR406;c__AB16;o__SSW63Au
testkevinmerged210	k__Bacteria;p__SR1;c__;o__
testkevinmerged211	k__Bacteria;p__Synergistetes;c__Synergistia;o__Synergistales
testkevinmerged212	k__Bacteria;p__TM7;c__TM7-3;o__
testkevinmerged213	k__Bacteria;p__TM7;c__TM7-3;o__CW040
testkevinmerged214	k__Bacteria;p__Tenericutes;c__Mollicutes;o__RF39
testkevinmerged215	k__Bacteria;p__Tenericutes;c__RF3;o__ML615J-28
testkevinmerged216	k__Bacteria;p__Verrucomicrobia;Other;Other
testkevinmerged217	k__Bacteria;p__Verrucomicrobia;c__Opitutae;o__Puniceicoccales
testkevinmerged218	k__Bacteria;p__Verrucomicrobia;c__Opitutae;o__[Cerasicoccales]
testkevinmerged219	k__Bacteria;p__Verrucomicrobia;c__Verrucomicrobiae;o__Verrucomicrobiales
testkevinmerged220	k__Bacteria;p__WS3;c__PRR-12;o__Sediment-1
testkevinmerged221	k__Bacteria;p__[Thermi];c__Deinococci;o__Deinococcales
testkevinmerged222	Unassigned;Other;Other;Other;Other
testkevinmerged223	k__Archaea;Other;Other;Other;Other
testkevinmerged224	k__Archaea;p__Crenarchaeota;Other;Other;Other
testkevinmerged225	k__Archaea;p__Crenarchaeota;c__MBGA;o__NRP-J;f__
testkevinmerged226	k__Archaea;p__Crenarchaeota;c__MCG;o__pGrfC26;f__
testkevinmerged227	k__Archaea;p__Crenarchaeota;c__Thaumarchaeota;o__Cenarchaeales;f__Cenarchaeaceae
testkevinmerged228	k__Archaea;p__Crenarchaeota;c__Thermoprotei;o__Desulfurococcales;f__Desulfurococcaceae
testkevinmerged229	k__Archaea;p__Crenarchaeota;c__Thermoprotei;o__Thermoproteales;f__Thermoproteaceae
testkevinmerged230	k__Archaea;p__Euryarchaeota;Other;Other;Other
testkevinmerged231	k__Archaea;p__Euryarchaeota;c__ANME-1;o__;f__
testkevinmerged232	k__Archaea;p__Euryarchaeota;c__DSEG;o__DHVE3;f__
testkevinmerged233	k__Archaea;p__Euryarchaeota;c__Halobacteria;o__Halobacteriales;f__Halobacteriaceae
testkevinmerged234	k__Archaea;p__Euryarchaeota;c__Methanomicrobia;o__Methanomicrobiales;Other
testkevinmerged235	k__Archaea;p__Euryarchaeota;c__Methanomicrobia;o__Methanomicrobiales;f__Methanomicrobiaceae
testkevinmerged236	k__Archaea;p__Euryarchaeota;c__Methanomicrobia;o__Methanomicrobiales;f__Methanoregulaceae
testkevinmerged237	k__Archaea;p__Euryarchaeota;c__Methanomicrobia;o__Methanosarcinales;f__ANME-2D
testkevinmerged238	k__Archaea;p__Euryarchaeota;c__Thermoplasmata;o__Thermoplasmatales;f__Picrophilaceae
testkevinmerged239	k__Bacteria;Other;Other;Other;Other
testkevinmerged240	k__Bacteria;p__Acidobacteria;c__Acidobacteria-6;Other;Other
testkevinmerged241	k__Bacteria;p__Actinobacteria;Other;Other;Other
testkevinmerged242	k__Bacteria;p__Actinobacteria;c__Acidimicrobiia;o__Acidimicrobiales;Other
testkevinmerged243	k__Bacteria;p__Actinobacteria;c__Actinobacteria;o__Actinomycetales;Other
testkevinmerged244	k__Bacteria;p__Actinobacteria;c__Actinobacteria;o__Actinomycetales;f__Actinomycetaceae
testkevinmerged245	k__Bacteria;p__Actinobacteria;c__Actinobacteria;o__Actinomycetales;f__Brevibacteriaceae
testkevinmerged246	k__Bacteria;p__Actinobacteria;c__Actinobacteria;o__Actinomycetales;f__Corynebacteriaceae
testkevinmerged247	k__Bacteria;p__Actinobacteria;c__Actinobacteria;o__Actinomycetales;f__Dietziaceae
testkevinmerged248	k__Bacteria;p__Actinobacteria;c__Actinobacteria;o__Actinomycetales;f__Microbacteriaceae
testkevinmerged249	k__Bacteria;p__Actinobacteria;c__Actinobacteria;o__Actinomycetales;f__Promicromonosporaceae
testkevinmerged250	k__Bacteria;p__Actinobacteria;c__Actinobacteria;o__Actinomycetales;f__Propionibacteriaceae
testkevinmerged251	k__Bacteria;p__Actinobacteria;c__Actinobacteria;o__Bifidobacteriales;f__Bifidobacteriaceae
testkevinmerged252	k__Bacteria;p__Actinobacteria;c__Coriobacteriia;o__Coriobacteriales;f__Coriobacteriaceae
testkevinmerged253	k__Bacteria;p__Actinobacteria;c__OPB41;o__;f__
testkevinmerged254	k__Bacteria;p__Actinobacteria;c__Thermoleophilia;Other;Other
testkevinmerged255	k__Bacteria;p__Actinobacteria;c__Thermoleophilia;o__Solirubrobacterales;f__
testkevinmerged256	k__Bacteria;p__Bacteroidetes;Other;Other;Other
testkevinmerged257	k__Bacteria;p__Bacteroidetes;c__Bacteroidia;o__Bacteroidales;Other
testkevinmerged258	k__Bacteria;p__Bacteroidetes;c__Bacteroidia;o__Bacteroidales;f__
testkevinmerged259	k__Bacteria;p__Bacteroidetes;c__Bacteroidia;o__Bacteroidales;f__Bacteroidaceae
testkevinmerged260	k__Bacteria;p__Bacteroidetes;c__Bacteroidia;o__Bacteroidales;f__Marinilabiaceae
testkevinmerged261	k__Bacteria;p__Bacteroidetes;c__Bacteroidia;o__Bacteroidales;f__Porphyromonadaceae
testkevinmerged262	k__Bacteria;p__Bacteroidetes;c__Bacteroidia;o__Bacteroidales;f__Prevotellaceae
testkevinmerged263	k__Bacteria;p__Bacteroidetes;c__Bacteroidia;o__Bacteroidales;f__Rikenellaceae
testkevinmerged264	k__Bacteria;p__Bacteroidetes;c__Bacteroidia;o__Bacteroidales;f__S24-7
testkevinmerged265	k__Bacteria;p__Bacteroidetes;c__Bacteroidia;o__Bacteroidales;f__[Barnesiellaceae]
testkevinmerged266	k__Bacteria;p__Bacteroidetes;c__Bacteroidia;o__Bacteroidales;f__[Odoribacteraceae]
testkevinmerged267	k__Bacteria;p__Bacteroidetes;c__Bacteroidia;o__Bacteroidales;f__[Paraprevotellaceae]
testkevinmerged268	k__Bacteria;p__Bacteroidetes;c__Cytophagia;o__Cytophagales;f__Cytophagaceae
testkevinmerged269	k__Bacteria;p__Bacteroidetes;c__Flavobacteriia;o__Flavobacteriales;Other
testkevinmerged270	k__Bacteria;p__Bacteroidetes;c__Flavobacteriia;o__Flavobacteriales;f__Flavobacteriaceae
testkevinmerged271	k__Bacteria;p__Bacteroidetes;c__Flavobacteriia;o__Flavobacteriales;f__[Weeksellaceae]
testkevinmerged272	k__Bacteria;p__Bacteroidetes;c__Sphingobacteriia;o__Sphingobacteriales;f__Sphingobacteriaceae
testkevinmerged273	k__Bacteria;p__Bacteroidetes;c__[Saprospirae];o__[Saprospirales];f__Chitinophagaceae
testkevinmerged274	k__Bacteria;p__Chloroflexi;Other;Other;Other
testkevinmerged275	k__Bacteria;p__Chloroflexi;c__Anaerolineae;Other;Other
testkevinmerged276	k__Bacteria;p__Chloroflexi;c__Anaerolineae;o__CFB-26;f__
testkevinmerged277	k__Bacteria;p__Chloroflexi;c__Anaerolineae;o__OPB11;f__
testkevinmerged278	k__Bacteria;p__Chloroflexi;c__Anaerolineae;o__S0208;f__
testkevinmerged279	k__Bacteria;p__Chloroflexi;c__Anaerolineae;o__SBR1031;f__A4b
testkevinmerged280	k__Bacteria;p__Chloroflexi;c__Anaerolineae;o__SBR1031;f__SJA-101
testkevinmerged281	k__Bacteria;p__Chloroflexi;c__Chloroflexi;o__[Roseiflexales];f__
testkevinmerged282	k__Bacteria;p__Chloroflexi;c__Dehalococcoidetes;o__Dehalococcoidales;f__Dehalococcoidaceae
testkevinmerged283	k__Bacteria;p__Chloroflexi;c__Ktedonobacteria;o__B12-WMSP1;f__
testkevinmerged284	k__Bacteria;p__Chloroflexi;c__SAR202;o__;f__
testkevinmerged285	k__Bacteria;p__Cyanobacteria;Other;Other;Other
testkevinmerged286	k__Bacteria;p__Cyanobacteria;c__4C0d-2;o__MLE1-12;f__
testkevinmerged287	k__Bacteria;p__Cyanobacteria;c__4C0d-2;o__YS2;f__
testkevinmerged288	k__Bacteria;p__Cyanobacteria;c__Chloroplast;o__Chlorophyta;f__
testkevinmerged289	k__Bacteria;p__Cyanobacteria;c__Chloroplast;o__Streptophyta;f__
testkevinmerged290	k__Bacteria;p__Cyanobacteria;c__Nostocophycideae;o__Nostocales;Other
testkevinmerged291	k__Bacteria;p__Cyanobacteria;c__Synechococcophycideae;o__Pseudanabaenales;f__Pseudanabaenaceae
testkevinmerged292	k__Bacteria;p__Firmicutes;Other;Other;Other
testkevinmerged293	k__Bacteria;p__Firmicutes;c__Bacilli;Other;Other
testkevinmerged294	k__Bacteria;p__Firmicutes;c__Bacilli;o__Bacillales;Other
testkevinmerged295	k__Bacteria;p__Firmicutes;c__Bacilli;o__Bacillales;f__Bacillaceae
testkevinmerged296	k__Bacteria;p__Firmicutes;c__Bacilli;o__Bacillales;f__Planococcaceae
testkevinmerged297	k__Bacteria;p__Firmicutes;c__Bacilli;o__Bacillales;f__Staphylococcaceae
testkevinmerged298	k__Bacteria;p__Firmicutes;c__Bacilli;o__Gemellales;f__Gemellaceae
testkevinmerged299	k__Bacteria;p__Firmicutes;c__Bacilli;o__Lactobacillales;Other
testkevinmerged300	k__Bacteria;p__Firmicutes;c__Bacilli;o__Lactobacillales;f__
testkevinmerged301	k__Bacteria;p__Firmicutes;c__Bacilli;o__Lactobacillales;f__Aerococcaceae
testkevinmerged302	k__Bacteria;p__Firmicutes;c__Bacilli;o__Lactobacillales;f__Carnobacteriaceae
testkevinmerged303	k__Bacteria;p__Firmicutes;c__Bacilli;o__Lactobacillales;f__Enterococcaceae
testkevinmerged304	k__Bacteria;p__Firmicutes;c__Bacilli;o__Lactobacillales;f__Lactobacillaceae
testkevinmerged305	k__Bacteria;p__Firmicutes;c__Bacilli;o__Lactobacillales;f__Leuconostocaceae
testkevinmerged306	k__Bacteria;p__Firmicutes;c__Bacilli;o__Lactobacillales;f__Streptococcaceae
testkevinmerged307	k__Bacteria;p__Firmicutes;c__Bacilli;o__Turicibacterales;f__Turicibacteraceae
testkevinmerged308	k__Bacteria;p__Firmicutes;c__Clostridia;Other;Other
testkevinmerged309	k__Bacteria;p__Firmicutes;c__Clostridia;o__;f__
testkevinmerged310	k__Bacteria;p__Firmicutes;c__Clostridia;o__Clostridiales;Other
testkevinmerged311	k__Bacteria;p__Firmicutes;c__Clostridia;o__Clostridiales;f__
testkevinmerged312	k__Bacteria;p__Firmicutes;c__Clostridia;o__Clostridiales;f__Christensenellaceae
testkevinmerged313	k__Bacteria;p__Firmicutes;c__Clostridia;o__Clostridiales;f__Clostridiaceae
testkevinmerged314	k__Bacteria;p__Firmicutes;c__Clostridia;o__Clostridiales;f__Dehalobacteriaceae
testkevinmerged315	k__Bacteria;p__Firmicutes;c__Clostridia;o__Clostridiales;f__EtOH8
testkevinmerged316	k__Bacteria;p__Firmicutes;c__Clostridia;o__Clostridiales;f__Eubacteriaceae
testkevinmerged317	k__Bacteria;p__Firmicutes;c__Clostridia;o__Clostridiales;f__Lachnospiraceae
testkevinmerged318	k__Bacteria;p__Firmicutes;c__Clostridia;o__Clostridiales;f__Peptococcaceae
testkevinmerged319	k__Bacteria;p__Firmicutes;c__Clostridia;o__Clostridiales;f__Peptostreptococcaceae
testkevinmerged320	k__Bacteria;p__Firmicutes;c__Clostridia;o__Clostridiales;f__Ruminococcaceae
testkevinmerged321	k__Bacteria;p__Firmicutes;c__Clostridia;o__Clostridiales;f__Veillonellaceae
testkevinmerged322	k__Bacteria;p__Firmicutes;c__Clostridia;o__Clostridiales;f__[Mogibacteriaceae]
testkevinmerged323	k__Bacteria;p__Firmicutes;c__Clostridia;o__Clostridiales;f__[Tissierellaceae]
testkevinmerged324	k__Bacteria;p__Firmicutes;c__Clostridia;o__SHA-98;f__
testkevinmerged325	k__Bacteria;p__Firmicutes;c__Erysipelotrichi;o__Erysipelotrichales;f__Erysipelotrichaceae
testkevinmerged326	k__Bacteria;p__Fusobacteria;c__Fusobacteriia;o__Fusobacteriales;Other
testkevinmerged327	k__Bacteria;p__Fusobacteria;c__Fusobacteriia;o__Fusobacteriales;f__Fusobacteriaceae
testkevinmerged328	k__Bacteria;p__Fusobacteria;c__Fusobacteriia;o__Fusobacteriales;f__Leptotrichiaceae
testkevinmerged329	k__Bacteria;p__GN02;c__3BR-5F;o__;f__
testkevinmerged330	k__Bacteria;p__Gemmatimonadetes;c__Gemm-2;o__;f__
testkevinmerged331	k__Bacteria;p__Gemmatimonadetes;c__Gemm-3;o__;f__
testkevinmerged332	k__Bacteria;p__Gemmatimonadetes;c__Gemm-5;o__;f__
testkevinmerged333	k__Bacteria;p__Gemmatimonadetes;c__Gemmatimonadetes;o__;f__
testkevinmerged334	k__Bacteria;p__Lentisphaerae;c__[Lentisphaeria];o__Victivallales;f__Victivallaceae
testkevinmerged335	k__Bacteria;p__OP1;c__[Acetothermia];o__[Acetothermales];f__
testkevinmerged336	k__Bacteria;p__OP8;c__OP8_2;o__;f__
testkevinmerged337	k__Bacteria;p__Planctomycetes;Other;Other;Other
testkevinmerged338	k__Bacteria;p__Planctomycetes;c__;o__;f__
testkevinmerged339	k__Bacteria;p__Planctomycetes;c__OM190;o__agg27;f__
testkevinmerged340	k__Bacteria;p__Planctomycetes;c__Phycisphaerae;Other;Other
testkevinmerged341	k__Bacteria;p__Planctomycetes;c__Phycisphaerae;o__Phycisphaerales;f__
testkevinmerged342	k__Bacteria;p__Planctomycetes;c__Phycisphaerae;o__mle1-8;f__
testkevinmerged343	k__Bacteria;p__Proteobacteria;Other;Other;Other
testkevinmerged344	k__Bacteria;p__Proteobacteria;c__Alphaproteobacteria;Other;Other
testkevinmerged345	k__Bacteria;p__Proteobacteria;c__Alphaproteobacteria;o__Caulobacterales;f__Caulobacteraceae
testkevinmerged346	k__Bacteria;p__Proteobacteria;c__Alphaproteobacteria;o__RF32;f__
testkevinmerged347	k__Bacteria;p__Proteobacteria;c__Alphaproteobacteria;o__Rhizobiales;Other
testkevinmerged348	k__Bacteria;p__Proteobacteria;c__Alphaproteobacteria;o__Rhizobiales;f__
testkevinmerged349	k__Bacteria;p__Proteobacteria;c__Alphaproteobacteria;o__Rhizobiales;f__Beijerinckiaceae
testkevinmerged350	k__Bacteria;p__Proteobacteria;c__Alphaproteobacteria;o__Rhizobiales;f__Bradyrhizobiaceae
testkevinmerged351	k__Bacteria;p__Proteobacteria;c__Alphaproteobacteria;o__Rhizobiales;f__Hyphomicrobiaceae
testkevinmerged352	k__Bacteria;p__Proteobacteria;c__Alphaproteobacteria;o__Rhizobiales;f__Methylobacteriaceae
testkevinmerged353	k__Bacteria;p__Proteobacteria;c__Alphaproteobacteria;o__Rhizobiales;f__Phyllobacteriaceae
testkevinmerged354	k__Bacteria;p__Proteobacteria;c__Alphaproteobacteria;o__Rhodobacterales;f__Rhodobacteraceae
testkevinmerged355	k__Bacteria;p__Proteobacteria;c__Alphaproteobacteria;o__Sphingomonadales;f__Sphingomonadaceae
testkevinmerged356	k__Bacteria;p__Proteobacteria;c__Betaproteobacteria;Other;Other
testkevinmerged357	k__Bacteria;p__Proteobacteria;c__Betaproteobacteria;o__;f__
testkevinmerged358	k__Bacteria;p__Proteobacteria;c__Betaproteobacteria;o__Burkholderiales;Other
testkevinmerged359	k__Bacteria;p__Proteobacteria;c__Betaproteobacteria;o__Burkholderiales;f__Alcaligenaceae
testkevinmerged360	k__Bacteria;p__Proteobacteria;c__Betaproteobacteria;o__Burkholderiales;f__Burkholderiaceae
testkevinmerged361	k__Bacteria;p__Proteobacteria;c__Betaproteobacteria;o__Burkholderiales;f__Comamonadaceae
testkevinmerged362	k__Bacteria;p__Proteobacteria;c__Betaproteobacteria;o__Burkholderiales;f__Oxalobacteraceae
testkevinmerged363	k__Bacteria;p__Proteobacteria;c__Betaproteobacteria;o__Gallionellales;f__Gallionellaceae
testkevinmerged364	k__Bacteria;p__Proteobacteria;c__Betaproteobacteria;o__Methylophilales;f__Methylophilaceae
testkevinmerged365	k__Bacteria;p__Proteobacteria;c__Betaproteobacteria;o__Neisseriales;f__Neisseriaceae
testkevinmerged366	k__Bacteria;p__Proteobacteria;c__Betaproteobacteria;o__Rhodocyclales;f__Rhodocyclaceae
testkevinmerged367	k__Bacteria;p__Proteobacteria;c__Deltaproteobacteria;Other;Other
testkevinmerged368	k__Bacteria;p__Proteobacteria;c__Deltaproteobacteria;o__;f__
testkevinmerged369	k__Bacteria;p__Proteobacteria;c__Deltaproteobacteria;o__Desulfobacterales;f__Desulfobulbaceae
testkevinmerged370	k__Bacteria;p__Proteobacteria;c__Deltaproteobacteria;o__Desulfovibrionales;f__Desulfovibrionaceae
testkevinmerged371	k__Bacteria;p__Proteobacteria;c__Deltaproteobacteria;o__Myxococcales;Other
testkevinmerged372	k__Bacteria;p__Proteobacteria;c__Deltaproteobacteria;o__Myxococcales;f__
testkevinmerged373	k__Bacteria;p__Proteobacteria;c__Deltaproteobacteria;o__Myxococcales;f__Haliangiaceae
testkevinmerged374	k__Bacteria;p__Proteobacteria;c__Deltaproteobacteria;o__PB19;f__
testkevinmerged375	k__Bacteria;p__Proteobacteria;c__Deltaproteobacteria;o__Syntrophobacterales;f__Syntrophobacteraceae
testkevinmerged376	k__Bacteria;p__Proteobacteria;c__Deltaproteobacteria;o__Thermodesulfobacteriales;f__
testkevinmerged377	k__Bacteria;p__Proteobacteria;c__Epsilonproteobacteria;o__Campylobacterales;f__Campylobacteraceae
testkevinmerged378	k__Bacteria;p__Proteobacteria;c__Gammaproteobacteria;Other;Other
testkevinmerged379	k__Bacteria;p__Proteobacteria;c__Gammaproteobacteria;o__Aeromonadales;f__Aeromonadaceae
testkevinmerged380	k__Bacteria;p__Proteobacteria;c__Gammaproteobacteria;o__Alteromonadales;Other
testkevinmerged381	k__Bacteria;p__Proteobacteria;c__Gammaproteobacteria;o__Alteromonadales;f__Alteromonadaceae
testkevinmerged382	k__Bacteria;p__Proteobacteria;c__Gammaproteobacteria;o__Cardiobacteriales;f__Cardiobacteriaceae
testkevinmerged383	k__Bacteria;p__Proteobacteria;c__Gammaproteobacteria;o__Enterobacteriales;f__Enterobacteriaceae
testkevinmerged384	k__Bacteria;p__Proteobacteria;c__Gammaproteobacteria;o__Legionellales;f__Coxiellaceae
testkevinmerged385	k__Bacteria;p__Proteobacteria;c__Gammaproteobacteria;o__Legionellales;f__Francisellaceae
testkevinmerged386	k__Bacteria;p__Proteobacteria;c__Gammaproteobacteria;o__Oceanospirillales;f__Oceanospirillaceae
testkevinmerged387	k__Bacteria;p__Proteobacteria;c__Gammaproteobacteria;o__Pasteurellales;f__Pasteurellaceae
testkevinmerged388	k__Bacteria;p__Proteobacteria;c__Gammaproteobacteria;o__Pseudomonadales;Other
testkevinmerged389	k__Bacteria;p__Proteobacteria;c__Gammaproteobacteria;o__Pseudomonadales;f__Moraxellaceae
testkevinmerged390	k__Bacteria;p__Proteobacteria;c__Gammaproteobacteria;o__Pseudomonadales;f__Pseudomonadaceae
testkevinmerged391	k__Bacteria;p__Proteobacteria;c__Gammaproteobacteria;o__Thiotrichales;f__Piscirickettsiaceae
testkevinmerged392	k__Bacteria;p__Proteobacteria;c__Gammaproteobacteria;o__Vibrionales;f__Pseudoalteromonadaceae
testkevinmerged393	k__Bacteria;p__Proteobacteria;c__Gammaproteobacteria;o__Vibrionales;f__Vibrionaceae
testkevinmerged394	k__Bacteria;p__Proteobacteria;c__Gammaproteobacteria;o__Xanthomonadales;f__Sinobacteraceae
testkevinmerged395	k__Bacteria;p__Proteobacteria;c__Gammaproteobacteria;o__Xanthomonadales;f__Xanthomonadaceae
testkevinmerged396	k__Bacteria;p__SAR406;c__AB16;o__;f__
testkevinmerged397	k__Bacteria;p__SAR406;c__AB16;o__SSW63Au;f__SHAS460
testkevinmerged398	k__Bacteria;p__SR1;c__;o__;f__
testkevinmerged399	k__Bacteria;p__Synergistetes;c__Synergistia;o__Synergistales;f__Dethiosulfovibrionaceae
testkevinmerged400	k__Bacteria;p__TM7;c__TM7-3;o__;f__
testkevinmerged401	k__Bacteria;p__TM7;c__TM7-3;o__CW040;f__
testkevinmerged402	k__Bacteria;p__TM7;c__TM7-3;o__CW040;f__F16
testkevinmerged403	k__Bacteria;p__Tenericutes;c__Mollicutes;o__RF39;f__
testkevinmerged404	k__Bacteria;p__Tenericutes;c__RF3;o__ML615J-28;f__
testkevinmerged405	k__Bacteria;p__Verrucomicrobia;Other;Other;Other
testkevinmerged406	k__Bacteria;p__Verrucomicrobia;c__Opitutae;o__Puniceicoccales;f__Puniceicoccaceae
testkevinmerged407	k__Bacteria;p__Verrucomicrobia;c__Opitutae;o__[Cerasicoccales];f__[Cerasicoccaceae]
testkevinmerged408	k__Bacteria;p__Verrucomicrobia;c__Verrucomicrobiae;o__Verrucomicrobiales;f__Verrucomicrobiaceae
testkevinmerged409	k__Bacteria;p__WS3;c__PRR-12;o__Sediment-1;f__
testkevinmerged410	k__Bacteria;p__[Thermi];c__Deinococci;o__Deinococcales;f__Deinococcaceae
testkevinmerged411	Unassigned;Other;Other;Other;Other;Other
testkevinmerged412	k__Archaea;Other;Other;Other;Other;Other
testkevinmerged413	k__Archaea;p__Crenarchaeota;Other;Other;Other;Other
testkevinmerged414	k__Archaea;p__Crenarchaeota;c__MBGA;o__NRP-J;f__;g__
testkevinmerged415	k__Archaea;p__Crenarchaeota;c__MCG;o__pGrfC26;f__;g__
testkevinmerged416	k__Archaea;p__Crenarchaeota;c__Thaumarchaeota;o__Cenarchaeales;f__Cenarchaeaceae;g__Nitrosopumilus
testkevinmerged417	k__Archaea;p__Crenarchaeota;c__Thermoprotei;o__Desulfurococcales;f__Desulfurococcaceae;Other
testkevinmerged418	k__Archaea;p__Crenarchaeota;c__Thermoprotei;o__Thermoproteales;f__Thermoproteaceae;g__
testkevinmerged419	k__Archaea;p__Euryarchaeota;Other;Other;Other;Other
testkevinmerged420	k__Archaea;p__Euryarchaeota;c__ANME-1;o__;f__;g__
testkevinmerged421	k__Archaea;p__Euryarchaeota;c__DSEG;o__DHVE3;f__;g__
testkevinmerged422	k__Archaea;p__Euryarchaeota;c__Halobacteria;o__Halobacteriales;f__Halobacteriaceae;Other
testkevinmerged423	k__Archaea;p__Euryarchaeota;c__Methanomicrobia;o__Methanomicrobiales;Other;Other
testkevinmerged424	k__Archaea;p__Euryarchaeota;c__Methanomicrobia;o__Methanomicrobiales;f__Methanomicrobiaceae;g__Methanoplanus
testkevinmerged425	k__Archaea;p__Euryarchaeota;c__Methanomicrobia;o__Methanomicrobiales;f__Methanoregulaceae;g__Candidatus Methanoregula
testkevinmerged426	k__Archaea;p__Euryarchaeota;c__Methanomicrobia;o__Methanosarcinales;f__ANME-2D;g__
testkevinmerged427	k__Archaea;p__Euryarchaeota;c__Thermoplasmata;o__Thermoplasmatales;f__Picrophilaceae;g__Thermogymnomonas
testkevinmerged428	k__Bacteria;Other;Other;Other;Other;Other
testkevinmerged429	k__Bacteria;p__Acidobacteria;c__Acidobacteria-6;Other;Other;Other
testkevinmerged430	k__Bacteria;p__Actinobacteria;Other;Other;Other;Other
testkevinmerged431	k__Bacteria;p__Actinobacteria;c__Acidimicrobiia;o__Acidimicrobiales;Other;Other
testkevinmerged432	k__Bacteria;p__Actinobacteria;c__Actinobacteria;o__Actinomycetales;Other;Other
testkevinmerged433	k__Bacteria;p__Actinobacteria;c__Actinobacteria;o__Actinomycetales;f__Actinomycetaceae;Other
testkevinmerged434	k__Bacteria;p__Actinobacteria;c__Actinobacteria;o__Actinomycetales;f__Actinomycetaceae;g__
testkevinmerged435	k__Bacteria;p__Actinobacteria;c__Actinobacteria;o__Actinomycetales;f__Actinomycetaceae;g__Actinomyces
testkevinmerged436	k__Bacteria;p__Actinobacteria;c__Actinobacteria;o__Actinomycetales;f__Brevibacteriaceae;g__Brevibacterium
testkevinmerged437	k__Bacteria;p__Actinobacteria;c__Actinobacteria;o__Actinomycetales;f__Corynebacteriaceae;g__Corynebacterium
testkevinmerged438	k__Bacteria;p__Actinobacteria;c__Actinobacteria;o__Actinomycetales;f__Dietziaceae;g__Dietzia
testkevinmerged439	k__Bacteria;p__Actinobacteria;c__Actinobacteria;o__Actinomycetales;f__Microbacteriaceae;g__
testkevinmerged440	k__Bacteria;p__Actinobacteria;c__Actinobacteria;o__Actinomycetales;f__Microbacteriaceae;g__Microbacterium
testkevinmerged441	k__Bacteria;p__Actinobacteria;c__Actinobacteria;o__Actinomycetales;f__Promicromonosporaceae;g__Cellulosimicrobium
testkevinmerged442	k__Bacteria;p__Actinobacteria;c__Actinobacteria;o__Actinomycetales;f__Propionibacteriaceae;Other
testkevinmerged443	k__Bacteria;p__Actinobacteria;c__Actinobacteria;o__Actinomycetales;f__Propionibacteriaceae;g__Propionibacterium
testkevinmerged444	k__Bacteria;p__Actinobacteria;c__Actinobacteria;o__Bifidobacteriales;f__Bifidobacteriaceae;g__Bifidobacterium
testkevinmerged445	k__Bacteria;p__Actinobacteria;c__Coriobacteriia;o__Coriobacteriales;f__Coriobacteriaceae;Other
testkevinmerged446	k__Bacteria;p__Actinobacteria;c__Coriobacteriia;o__Coriobacteriales;f__Coriobacteriaceae;g__
testkevinmerged447	k__Bacteria;p__Actinobacteria;c__Coriobacteriia;o__Coriobacteriales;f__Coriobacteriaceae;g__Adlercreutzia
testkevinmerged448	k__Bacteria;p__Actinobacteria;c__Coriobacteriia;o__Coriobacteriales;f__Coriobacteriaceae;g__Atopobium
testkevinmerged449	k__Bacteria;p__Actinobacteria;c__Coriobacteriia;o__Coriobacteriales;f__Coriobacteriaceae;g__Collinsella
testkevinmerged450	k__Bacteria;p__Actinobacteria;c__Coriobacteriia;o__Coriobacteriales;f__Coriobacteriaceae;g__Eggerthella
testkevinmerged451	k__Bacteria;p__Actinobacteria;c__Coriobacteriia;o__Coriobacteriales;f__Coriobacteriaceae;g__Slackia
testkevinmerged452	k__Bacteria;p__Actinobacteria;c__OPB41;o__;f__;g__
testkevinmerged453	k__Bacteria;p__Actinobacteria;c__Thermoleophilia;Other;Other;Other
testkevinmerged454	k__Bacteria;p__Actinobacteria;c__Thermoleophilia;o__Solirubrobacterales;f__;g__
testkevinmerged455	k__Bacteria;p__Bacteroidetes;Other;Other;Other;Other
testkevinmerged456	k__Bacteria;p__Bacteroidetes;c__Bacteroidia;o__Bacteroidales;Other;Other
testkevinmerged457	k__Bacteria;p__Bacteroidetes;c__Bacteroidia;o__Bacteroidales;f__;g__
testkevinmerged458	k__Bacteria;p__Bacteroidetes;c__Bacteroidia;o__Bacteroidales;f__Bacteroidaceae;Other
testkevinmerged459	k__Bacteria;p__Bacteroidetes;c__Bacteroidia;o__Bacteroidales;f__Bacteroidaceae;g__
testkevinmerged460	k__Bacteria;p__Bacteroidetes;c__Bacteroidia;o__Bacteroidales;f__Bacteroidaceae;g__Bacteroides
testkevinmerged461	k__Bacteria;p__Bacteroidetes;c__Bacteroidia;o__Bacteroidales;f__Marinilabiaceae;g__
testkevinmerged462	k__Bacteria;p__Bacteroidetes;c__Bacteroidia;o__Bacteroidales;f__Porphyromonadaceae;Other
testkevinmerged463	k__Bacteria;p__Bacteroidetes;c__Bacteroidia;o__Bacteroidales;f__Porphyromonadaceae;g__
testkevinmerged464	k__Bacteria;p__Bacteroidetes;c__Bacteroidia;o__Bacteroidales;f__Porphyromonadaceae;g__Candidatus Azobacteroides
testkevinmerged465	k__Bacteria;p__Bacteroidetes;c__Bacteroidia;o__Bacteroidales;f__Porphyromonadaceae;g__Dysgonomonas
testkevinmerged466	k__Bacteria;p__Bacteroidetes;c__Bacteroidia;o__Bacteroidales;f__Porphyromonadaceae;g__Parabacteroides
testkevinmerged467	k__Bacteria;p__Bacteroidetes;c__Bacteroidia;o__Bacteroidales;f__Porphyromonadaceae;g__Porphyromonas
testkevinmerged468	k__Bacteria;p__Bacteroidetes;c__Bacteroidia;o__Bacteroidales;f__Prevotellaceae;Other
testkevinmerged469	k__Bacteria;p__Bacteroidetes;c__Bacteroidia;o__Bacteroidales;f__Prevotellaceae;g__Prevotella
testkevinmerged470	k__Bacteria;p__Bacteroidetes;c__Bacteroidia;o__Bacteroidales;f__Rikenellaceae;Other
testkevinmerged471	k__Bacteria;p__Bacteroidetes;c__Bacteroidia;o__Bacteroidales;f__Rikenellaceae;g__
testkevinmerged472	k__Bacteria;p__Bacteroidetes;c__Bacteroidia;o__Bacteroidales;f__Rikenellaceae;g__Alistipes
testkevinmerged473	k__Bacteria;p__Bacteroidetes;c__Bacteroidia;o__Bacteroidales;f__S24-7;g__
testkevinmerged474	k__Bacteria;p__Bacteroidetes;c__Bacteroidia;o__Bacteroidales;f__[Barnesiellaceae];Other
testkevinmerged475	k__Bacteria;p__Bacteroidetes;c__Bacteroidia;o__Bacteroidales;f__[Barnesiellaceae];g__
testkevinmerged476	k__Bacteria;p__Bacteroidetes;c__Bacteroidia;o__Bacteroidales;f__[Odoribacteraceae];Other
testkevinmerged477	k__Bacteria;p__Bacteroidetes;c__Bacteroidia;o__Bacteroidales;f__[Odoribacteraceae];g__Butyricimonas
testkevinmerged478	k__Bacteria;p__Bacteroidetes;c__Bacteroidia;o__Bacteroidales;f__[Odoribacteraceae];g__Odoribacter
testkevinmerged479	k__Bacteria;p__Bacteroidetes;c__Bacteroidia;o__Bacteroidales;f__[Paraprevotellaceae];Other
testkevinmerged480	k__Bacteria;p__Bacteroidetes;c__Bacteroidia;o__Bacteroidales;f__[Paraprevotellaceae];g__Paraprevotella
testkevinmerged481	k__Bacteria;p__Bacteroidetes;c__Bacteroidia;o__Bacteroidales;f__[Paraprevotellaceae];g__YRC22
testkevinmerged482	k__Bacteria;p__Bacteroidetes;c__Bacteroidia;o__Bacteroidales;f__[Paraprevotellaceae];g__[Prevotella]
testkevinmerged483	k__Bacteria;p__Bacteroidetes;c__Cytophagia;o__Cytophagales;f__Cytophagaceae;Other
testkevinmerged484	k__Bacteria;p__Bacteroidetes;c__Cytophagia;o__Cytophagales;f__Cytophagaceae;g__Hymenobacter
testkevinmerged485	k__Bacteria;p__Bacteroidetes;c__Flavobacteriia;o__Flavobacteriales;Other;Other
testkevinmerged486	k__Bacteria;p__Bacteroidetes;c__Flavobacteriia;o__Flavobacteriales;f__Flavobacteriaceae;Other
testkevinmerged487	k__Bacteria;p__Bacteroidetes;c__Flavobacteriia;o__Flavobacteriales;f__Flavobacteriaceae;g__
testkevinmerged488	k__Bacteria;p__Bacteroidetes;c__Flavobacteriia;o__Flavobacteriales;f__[Weeksellaceae];g__
testkevinmerged489	k__Bacteria;p__Bacteroidetes;c__Sphingobacteriia;o__Sphingobacteriales;f__Sphingobacteriaceae;g__Pedobacter
testkevinmerged490	k__Bacteria;p__Bacteroidetes;c__[Saprospirae];o__[Saprospirales];f__Chitinophagaceae;g__
testkevinmerged491	k__Bacteria;p__Bacteroidetes;c__[Saprospirae];o__[Saprospirales];f__Chitinophagaceae;g__Flavisolibacter
testkevinmerged492	k__Bacteria;p__Bacteroidetes;c__[Saprospirae];o__[Saprospirales];f__Chitinophagaceae;g__Sediminibacterium
testkevinmerged493	k__Bacteria;p__Chloroflexi;Other;Other;Other;Other
testkevinmerged494	k__Bacteria;p__Chloroflexi;c__Anaerolineae;Other;Other;Other
testkevinmerged495	k__Bacteria;p__Chloroflexi;c__Anaerolineae;o__CFB-26;f__;g__
testkevinmerged496	k__Bacteria;p__Chloroflexi;c__Anaerolineae;o__OPB11;f__;g__
testkevinmerged497	k__Bacteria;p__Chloroflexi;c__Anaerolineae;o__S0208;f__;g__
testkevinmerged498	k__Bacteria;p__Chloroflexi;c__Anaerolineae;o__SBR1031;f__A4b;g__
testkevinmerged499	k__Bacteria;p__Chloroflexi;c__Anaerolineae;o__SBR1031;f__SJA-101;g__
testkevinmerged500	k__Bacteria;p__Chloroflexi;c__Chloroflexi;o__[Roseiflexales];f__;g__
testkevinmerged501	k__Bacteria;p__Chloroflexi;c__Dehalococcoidetes;o__Dehalococcoidales;f__Dehalococcoidaceae;g__
testkevinmerged502	k__Bacteria;p__Chloroflexi;c__Ktedonobacteria;o__B12-WMSP1;f__;g__
testkevinmerged503	k__Bacteria;p__Chloroflexi;c__SAR202;o__;f__;g__
testkevinmerged504	k__Bacteria;p__Cyanobacteria;Other;Other;Other;Other
testkevinmerged505	k__Bacteria;p__Cyanobacteria;c__4C0d-2;o__MLE1-12;f__;g__
testkevinmerged506	k__Bacteria;p__Cyanobacteria;c__4C0d-2;o__YS2;f__;g__
testkevinmerged507	k__Bacteria;p__Cyanobacteria;c__Chloroplast;o__Chlorophyta;f__;g__
testkevinmerged508	k__Bacteria;p__Cyanobacteria;c__Chloroplast;o__Streptophyta;f__;g__
testkevinmerged509	k__Bacteria;p__Cyanobacteria;c__Nostocophycideae;o__Nostocales;Other;Other
testkevinmerged510	k__Bacteria;p__Cyanobacteria;c__Synechococcophycideae;o__Pseudanabaenales;f__Pseudanabaenaceae;g__Halomicronema
testkevinmerged511	k__Bacteria;p__Firmicutes;Other;Other;Other;Other
testkevinmerged512	k__Bacteria;p__Firmicutes;c__Bacilli;Other;Other;Other
testkevinmerged513	k__Bacteria;p__Firmicutes;c__Bacilli;o__Bacillales;Other;Other
testkevinmerged514	k__Bacteria;p__Firmicutes;c__Bacilli;o__Bacillales;f__Bacillaceae;Other
testkevinmerged515	k__Bacteria;p__Firmicutes;c__Bacilli;o__Bacillales;f__Bacillaceae;g__Bacillus
testkevinmerged516	k__Bacteria;p__Firmicutes;c__Bacilli;o__Bacillales;f__Planococcaceae;g__Solibacillus
testkevinmerged517	k__Bacteria;p__Firmicutes;c__Bacilli;o__Bacillales;f__Staphylococcaceae;Other
testkevinmerged518	k__Bacteria;p__Firmicutes;c__Bacilli;o__Bacillales;f__Staphylococcaceae;g__Staphylococcus
testkevinmerged519	k__Bacteria;p__Firmicutes;c__Bacilli;o__Gemellales;f__Gemellaceae;g__
testkevinmerged520	k__Bacteria;p__Firmicutes;c__Bacilli;o__Gemellales;f__Gemellaceae;g__Gemella
testkevinmerged521	k__Bacteria;p__Firmicutes;c__Bacilli;o__Lactobacillales;Other;Other
testkevinmerged522	k__Bacteria;p__Firmicutes;c__Bacilli;o__Lactobacillales;f__;g__
testkevinmerged523	k__Bacteria;p__Firmicutes;c__Bacilli;o__Lactobacillales;f__Aerococcaceae;g__Abiotrophia
testkevinmerged524	k__Bacteria;p__Firmicutes;c__Bacilli;o__Lactobacillales;f__Aerococcaceae;g__Alloiococcus
testkevinmerged525	k__Bacteria;p__Firmicutes;c__Bacilli;o__Lactobacillales;f__Carnobacteriaceae;g__Granulicatella
testkevinmerged526	k__Bacteria;p__Firmicutes;c__Bacilli;o__Lactobacillales;f__Enterococcaceae;Other
testkevinmerged527	k__Bacteria;p__Firmicutes;c__Bacilli;o__Lactobacillales;f__Enterococcaceae;g__
testkevinmerged528	k__Bacteria;p__Firmicutes;c__Bacilli;o__Lactobacillales;f__Enterococcaceae;g__Enterococcus
testkevinmerged529	k__Bacteria;p__Firmicutes;c__Bacilli;o__Lactobacillales;f__Enterococcaceae;g__Vagococcus
testkevinmerged530	k__Bacteria;p__Firmicutes;c__Bacilli;o__Lactobacillales;f__Lactobacillaceae;Other
testkevinmerged531	k__Bacteria;p__Firmicutes;c__Bacilli;o__Lactobacillales;f__Lactobacillaceae;g__Lactobacillus
testkevinmerged532	k__Bacteria;p__Firmicutes;c__Bacilli;o__Lactobacillales;f__Lactobacillaceae;g__Pediococcus
testkevinmerged533	k__Bacteria;p__Firmicutes;c__Bacilli;o__Lactobacillales;f__Leuconostocaceae;g__
testkevinmerged534	k__Bacteria;p__Firmicutes;c__Bacilli;o__Lactobacillales;f__Leuconostocaceae;g__Fructobacillus
testkevinmerged535	k__Bacteria;p__Firmicutes;c__Bacilli;o__Lactobacillales;f__Leuconostocaceae;g__Leuconostoc
testkevinmerged536	k__Bacteria;p__Firmicutes;c__Bacilli;o__Lactobacillales;f__Leuconostocaceae;g__Weissella
testkevinmerged537	k__Bacteria;p__Firmicutes;c__Bacilli;o__Lactobacillales;f__Streptococcaceae;g__
testkevinmerged538	k__Bacteria;p__Firmicutes;c__Bacilli;o__Lactobacillales;f__Streptococcaceae;g__Lactococcus
testkevinmerged539	k__Bacteria;p__Firmicutes;c__Bacilli;o__Lactobacillales;f__Streptococcaceae;g__Streptococcus
testkevinmerged540	k__Bacteria;p__Firmicutes;c__Bacilli;o__Turicibacterales;f__Turicibacteraceae;g__Turicibacter
testkevinmerged541	k__Bacteria;p__Firmicutes;c__Clostridia;Other;Other;Other
testkevinmerged542	k__Bacteria;p__Firmicutes;c__Clostridia;o__;f__;g__
testkevinmerged543	k__Bacteria;p__Firmicutes;c__Clostridia;o__Clostridiales;Other;Other
testkevinmerged544	k__Bacteria;p__Firmicutes;c__Clostridia;o__Clostridiales;f__;g__
testkevinmerged545	k__Bacteria;p__Firmicutes;c__Clostridia;o__Clostridiales;f__Christensenellaceae;g__
testkevinmerged546	k__Bacteria;p__Firmicutes;c__Clostridia;o__Clostridiales;f__Christensenellaceae;g__Christensenella
testkevinmerged547	k__Bacteria;p__Firmicutes;c__Clostridia;o__Clostridiales;f__Clostridiaceae;Other
testkevinmerged548	k__Bacteria;p__Firmicutes;c__Clostridia;o__Clostridiales;f__Clostridiaceae;g__
testkevinmerged549	k__Bacteria;p__Firmicutes;c__Clostridia;o__Clostridiales;f__Clostridiaceae;g__Clostridium
testkevinmerged550	k__Bacteria;p__Firmicutes;c__Clostridia;o__Clostridiales;f__Clostridiaceae;g__SMB53
testkevinmerged551	k__Bacteria;p__Firmicutes;c__Clostridia;o__Clostridiales;f__Dehalobacteriaceae;g__Dehalobacterium
testkevinmerged552	k__Bacteria;p__Firmicutes;c__Clostridia;o__Clostridiales;f__EtOH8;g__
testkevinmerged553	k__Bacteria;p__Firmicutes;c__Clostridia;o__Clostridiales;f__Eubacteriaceae;g__Anaerofustis
testkevinmerged554	k__Bacteria;p__Firmicutes;c__Clostridia;o__Clostridiales;f__Eubacteriaceae;g__Pseudoramibacter_Eubacterium
testkevinmerged555	k__Bacteria;p__Firmicutes;c__Clostridia;o__Clostridiales;f__Lachnospiraceae;Other
testkevinmerged556	k__Bacteria;p__Firmicutes;c__Clostridia;o__Clostridiales;f__Lachnospiraceae;g__
testkevinmerged557	k__Bacteria;p__Firmicutes;c__Clostridia;o__Clostridiales;f__Lachnospiraceae;g__Anaerostipes
testkevinmerged558	k__Bacteria;p__Firmicutes;c__Clostridia;o__Clostridiales;f__Lachnospiraceae;g__Blautia
testkevinmerged559	k__Bacteria;p__Firmicutes;c__Clostridia;o__Clostridiales;f__Lachnospiraceae;g__Coprococcus
testkevinmerged560	k__Bacteria;p__Firmicutes;c__Clostridia;o__Clostridiales;f__Lachnospiraceae;g__Dorea
testkevinmerged561	k__Bacteria;p__Firmicutes;c__Clostridia;o__Clostridiales;f__Lachnospiraceae;g__Epulopiscium
testkevinmerged562	k__Bacteria;p__Firmicutes;c__Clostridia;o__Clostridiales;f__Lachnospiraceae;g__Lachnospira
testkevinmerged563	k__Bacteria;p__Firmicutes;c__Clostridia;o__Clostridiales;f__Lachnospiraceae;g__Roseburia
testkevinmerged564	k__Bacteria;p__Firmicutes;c__Clostridia;o__Clostridiales;f__Lachnospiraceae;g__[Ruminococcus]
testkevinmerged565	k__Bacteria;p__Firmicutes;c__Clostridia;o__Clostridiales;f__Peptococcaceae;g__
testkevinmerged566	k__Bacteria;p__Firmicutes;c__Clostridia;o__Clostridiales;f__Peptococcaceae;g__Desulfosporosinus
testkevinmerged567	k__Bacteria;p__Firmicutes;c__Clostridia;o__Clostridiales;f__Peptococcaceae;g__Desulfotomaculum
testkevinmerged568	k__Bacteria;p__Firmicutes;c__Clostridia;o__Clostridiales;f__Peptococcaceae;g__Sporotomaculum
testkevinmerged569	k__Bacteria;p__Firmicutes;c__Clostridia;o__Clostridiales;f__Peptococcaceae;g__rc4-4
testkevinmerged570	k__Bacteria;p__Firmicutes;c__Clostridia;o__Clostridiales;f__Peptostreptococcaceae;Other
testkevinmerged571	k__Bacteria;p__Firmicutes;c__Clostridia;o__Clostridiales;f__Peptostreptococcaceae;g__
testkevinmerged572	k__Bacteria;p__Firmicutes;c__Clostridia;o__Clostridiales;f__Peptostreptococcaceae;g__Peptostreptococcus
testkevinmerged573	k__Bacteria;p__Firmicutes;c__Clostridia;o__Clostridiales;f__Ruminococcaceae;Other
testkevinmerged574	k__Bacteria;p__Firmicutes;c__Clostridia;o__Clostridiales;f__Ruminococcaceae;g__
testkevinmerged575	k__Bacteria;p__Firmicutes;c__Clostridia;o__Clostridiales;f__Ruminococcaceae;g__Anaerotruncus
testkevinmerged576	k__Bacteria;p__Firmicutes;c__Clostridia;o__Clostridiales;f__Ruminococcaceae;g__Faecalibacterium
testkevinmerged577	k__Bacteria;p__Firmicutes;c__Clostridia;o__Clostridiales;f__Ruminococcaceae;g__Oscillospira
testkevinmerged578	k__Bacteria;p__Firmicutes;c__Clostridia;o__Clostridiales;f__Ruminococcaceae;g__Ruminococcus
testkevinmerged579	k__Bacteria;p__Firmicutes;c__Clostridia;o__Clostridiales;f__Veillonellaceae;Other
testkevinmerged580	k__Bacteria;p__Firmicutes;c__Clostridia;o__Clostridiales;f__Veillonellaceae;g__
testkevinmerged581	k__Bacteria;p__Firmicutes;c__Clostridia;o__Clostridiales;f__Veillonellaceae;g__Acidaminococcus
testkevinmerged582	k__Bacteria;p__Firmicutes;c__Clostridia;o__Clostridiales;f__Veillonellaceae;g__Dialister
testkevinmerged583	k__Bacteria;p__Firmicutes;c__Clostridia;o__Clostridiales;f__Veillonellaceae;g__Megamonas
testkevinmerged584	k__Bacteria;p__Firmicutes;c__Clostridia;o__Clostridiales;f__Veillonellaceae;g__Megasphaera
testkevinmerged585	k__Bacteria;p__Firmicutes;c__Clostridia;o__Clostridiales;f__Veillonellaceae;g__Mitsuokella
testkevinmerged586	k__Bacteria;p__Firmicutes;c__Clostridia;o__Clostridiales;f__Veillonellaceae;g__Phascolarctobacterium
testkevinmerged587	k__Bacteria;p__Firmicutes;c__Clostridia;o__Clostridiales;f__Veillonellaceae;g__Selenomonas
testkevinmerged588	k__Bacteria;p__Firmicutes;c__Clostridia;o__Clostridiales;f__Veillonellaceae;g__Succiniclasticum
testkevinmerged589	k__Bacteria;p__Firmicutes;c__Clostridia;o__Clostridiales;f__Veillonellaceae;g__Veillonella
testkevinmerged590	k__Bacteria;p__Firmicutes;c__Clostridia;o__Clostridiales;f__[Mogibacteriaceae];g__
testkevinmerged591	k__Bacteria;p__Firmicutes;c__Clostridia;o__Clostridiales;f__[Mogibacteriaceae];g__Mogibacterium
testkevinmerged592	k__Bacteria;p__Firmicutes;c__Clostridia;o__Clostridiales;f__[Tissierellaceae];Other
testkevinmerged593	k__Bacteria;p__Firmicutes;c__Clostridia;o__Clostridiales;f__[Tissierellaceae];g__1-68
testkevinmerged594	k__Bacteria;p__Firmicutes;c__Clostridia;o__Clostridiales;f__[Tissierellaceae];g__Anaerococcus
testkevinmerged595	k__Bacteria;p__Firmicutes;c__Clostridia;o__Clostridiales;f__[Tissierellaceae];g__Finegoldia
testkevinmerged596	k__Bacteria;p__Firmicutes;c__Clostridia;o__Clostridiales;f__[Tissierellaceae];g__Gallicola
testkevinmerged597	k__Bacteria;p__Firmicutes;c__Clostridia;o__Clostridiales;f__[Tissierellaceae];g__Parvimonas
testkevinmerged598	k__Bacteria;p__Firmicutes;c__Clostridia;o__Clostridiales;f__[Tissierellaceae];g__Peptoniphilus
testkevinmerged599	k__Bacteria;p__Firmicutes;c__Clostridia;o__Clostridiales;f__[Tissierellaceae];g__WAL_1855D
testkevinmerged600	k__Bacteria;p__Firmicutes;c__Clostridia;o__SHA-98;f__;g__
testkevinmerged601	k__Bacteria;p__Firmicutes;c__Erysipelotrichi;o__Erysipelotrichales;f__Erysipelotrichaceae;g__
testkevinmerged602	k__Bacteria;p__Firmicutes;c__Erysipelotrichi;o__Erysipelotrichales;f__Erysipelotrichaceae;g__Allobaculum
testkevinmerged603	k__Bacteria;p__Firmicutes;c__Erysipelotrichi;o__Erysipelotrichales;f__Erysipelotrichaceae;g__Bulleidia
testkevinmerged604	k__Bacteria;p__Firmicutes;c__Erysipelotrichi;o__Erysipelotrichales;f__Erysipelotrichaceae;g__Catenibacterium
testkevinmerged605	k__Bacteria;p__Firmicutes;c__Erysipelotrichi;o__Erysipelotrichales;f__Erysipelotrichaceae;g__Coprobacillus
testkevinmerged606	k__Bacteria;p__Firmicutes;c__Erysipelotrichi;o__Erysipelotrichales;f__Erysipelotrichaceae;g__Holdemania
testkevinmerged607	k__Bacteria;p__Firmicutes;c__Erysipelotrichi;o__Erysipelotrichales;f__Erysipelotrichaceae;g__[Eubacterium]
testkevinmerged608	k__Bacteria;p__Firmicutes;c__Erysipelotrichi;o__Erysipelotrichales;f__Erysipelotrichaceae;g__cc_115
testkevinmerged609	k__Bacteria;p__Fusobacteria;c__Fusobacteriia;o__Fusobacteriales;Other;Other
testkevinmerged610	k__Bacteria;p__Fusobacteria;c__Fusobacteriia;o__Fusobacteriales;f__Fusobacteriaceae;Other
testkevinmerged611	k__Bacteria;p__Fusobacteria;c__Fusobacteriia;o__Fusobacteriales;f__Fusobacteriaceae;g__Fusobacterium
testkevinmerged612	k__Bacteria;p__Fusobacteria;c__Fusobacteriia;o__Fusobacteriales;f__Leptotrichiaceae;Other
testkevinmerged613	k__Bacteria;p__Fusobacteria;c__Fusobacteriia;o__Fusobacteriales;f__Leptotrichiaceae;g__Leptotrichia
testkevinmerged614	k__Bacteria;p__GN02;c__3BR-5F;o__;f__;g__
testkevinmerged615	k__Bacteria;p__Gemmatimonadetes;c__Gemm-2;o__;f__;g__
testkevinmerged616	k__Bacteria;p__Gemmatimonadetes;c__Gemm-3;o__;f__;g__
testkevinmerged617	k__Bacteria;p__Gemmatimonadetes;c__Gemm-5;o__;f__;g__
testkevinmerged618	k__Bacteria;p__Gemmatimonadetes;c__Gemmatimonadetes;o__;f__;g__
testkevinmerged619	k__Bacteria;p__Lentisphaerae;c__[Lentisphaeria];o__Victivallales;f__Victivallaceae;g__
testkevinmerged620	k__Bacteria;p__OP1;c__[Acetothermia];o__[Acetothermales];f__;g__
testkevinmerged621	k__Bacteria;p__OP8;c__OP8_2;o__;f__;g__
testkevinmerged622	k__Bacteria;p__Planctomycetes;Other;Other;Other;Other
testkevinmerged623	k__Bacteria;p__Planctomycetes;c__;o__;f__;g__
testkevinmerged624	k__Bacteria;p__Planctomycetes;c__OM190;o__agg27;f__;g__
testkevinmerged625	k__Bacteria;p__Planctomycetes;c__Phycisphaerae;Other;Other;Other
testkevinmerged626	k__Bacteria;p__Planctomycetes;c__Phycisphaerae;o__Phycisphaerales;f__;g__
testkevinmerged627	k__Bacteria;p__Planctomycetes;c__Phycisphaerae;o__mle1-8;f__;g__
testkevinmerged628	k__Bacteria;p__Proteobacteria;Other;Other;Other;Other
testkevinmerged629	k__Bacteria;p__Proteobacteria;c__Alphaproteobacteria;Other;Other;Other
testkevinmerged630	k__Bacteria;p__Proteobacteria;c__Alphaproteobacteria;o__Caulobacterales;f__Caulobacteraceae;g__
testkevinmerged631	k__Bacteria;p__Proteobacteria;c__Alphaproteobacteria;o__RF32;f__;g__
testkevinmerged632	k__Bacteria;p__Proteobacteria;c__Alphaproteobacteria;o__Rhizobiales;Other;Other
testkevinmerged633	k__Bacteria;p__Proteobacteria;c__Alphaproteobacteria;o__Rhizobiales;f__;g__
testkevinmerged634	k__Bacteria;p__Proteobacteria;c__Alphaproteobacteria;o__Rhizobiales;f__Beijerinckiaceae;g__
testkevinmerged635	k__Bacteria;p__Proteobacteria;c__Alphaproteobacteria;o__Rhizobiales;f__Bradyrhizobiaceae;g__
testkevinmerged636	k__Bacteria;p__Proteobacteria;c__Alphaproteobacteria;o__Rhizobiales;f__Hyphomicrobiaceae;g__Hyphomicrobium
testkevinmerged637	k__Bacteria;p__Proteobacteria;c__Alphaproteobacteria;o__Rhizobiales;f__Hyphomicrobiaceae;g__Rhodoplanes
testkevinmerged638	k__Bacteria;p__Proteobacteria;c__Alphaproteobacteria;o__Rhizobiales;f__Methylobacteriaceae;g__
testkevinmerged639	k__Bacteria;p__Proteobacteria;c__Alphaproteobacteria;o__Rhizobiales;f__Phyllobacteriaceae;Other
testkevinmerged640	k__Bacteria;p__Proteobacteria;c__Alphaproteobacteria;o__Rhizobiales;f__Phyllobacteriaceae;g__
testkevinmerged641	k__Bacteria;p__Proteobacteria;c__Alphaproteobacteria;o__Rhodobacterales;f__Rhodobacteraceae;Other
testkevinmerged642	k__Bacteria;p__Proteobacteria;c__Alphaproteobacteria;o__Rhodobacterales;f__Rhodobacteraceae;g__
testkevinmerged643	k__Bacteria;p__Proteobacteria;c__Alphaproteobacteria;o__Rhodobacterales;f__Rhodobacteraceae;g__Paracoccus
testkevinmerged644	k__Bacteria;p__Proteobacteria;c__Alphaproteobacteria;o__Sphingomonadales;f__Sphingomonadaceae;Other
testkevinmerged645	k__Bacteria;p__Proteobacteria;c__Alphaproteobacteria;o__Sphingomonadales;f__Sphingomonadaceae;g__
testkevinmerged646	k__Bacteria;p__Proteobacteria;c__Alphaproteobacteria;o__Sphingomonadales;f__Sphingomonadaceae;g__Sphingomonas
testkevinmerged647	k__Bacteria;p__Proteobacteria;c__Alphaproteobacteria;o__Sphingomonadales;f__Sphingomonadaceae;g__Sphingopyxis
testkevinmerged648	k__Bacteria;p__Proteobacteria;c__Betaproteobacteria;Other;Other;Other
testkevinmerged649	k__Bacteria;p__Proteobacteria;c__Betaproteobacteria;o__;f__;g__
testkevinmerged650	k__Bacteria;p__Proteobacteria;c__Betaproteobacteria;o__Burkholderiales;Other;Other
testkevinmerged651	k__Bacteria;p__Proteobacteria;c__Betaproteobacteria;o__Burkholderiales;f__Alcaligenaceae;g__
testkevinmerged652	k__Bacteria;p__Proteobacteria;c__Betaproteobacteria;o__Burkholderiales;f__Alcaligenaceae;g__Sutterella
testkevinmerged653	k__Bacteria;p__Proteobacteria;c__Betaproteobacteria;o__Burkholderiales;f__Burkholderiaceae;g__Burkholderia
testkevinmerged654	k__Bacteria;p__Proteobacteria;c__Betaproteobacteria;o__Burkholderiales;f__Comamonadaceae;Other
testkevinmerged655	k__Bacteria;p__Proteobacteria;c__Betaproteobacteria;o__Burkholderiales;f__Comamonadaceae;g__
testkevinmerged656	k__Bacteria;p__Proteobacteria;c__Betaproteobacteria;o__Burkholderiales;f__Comamonadaceae;g__Comamonas
testkevinmerged657	k__Bacteria;p__Proteobacteria;c__Betaproteobacteria;o__Burkholderiales;f__Comamonadaceae;g__Delftia
testkevinmerged658	k__Bacteria;p__Proteobacteria;c__Betaproteobacteria;o__Burkholderiales;f__Oxalobacteraceae;g__
testkevinmerged659	k__Bacteria;p__Proteobacteria;c__Betaproteobacteria;o__Burkholderiales;f__Oxalobacteraceae;g__Cupriavidus
testkevinmerged660	k__Bacteria;p__Proteobacteria;c__Betaproteobacteria;o__Burkholderiales;f__Oxalobacteraceae;g__Oxalobacter
testkevinmerged661	k__Bacteria;p__Proteobacteria;c__Betaproteobacteria;o__Burkholderiales;f__Oxalobacteraceae;g__Ralstonia
testkevinmerged662	k__Bacteria;p__Proteobacteria;c__Betaproteobacteria;o__Gallionellales;f__Gallionellaceae;g__Gallionella
testkevinmerged663	k__Bacteria;p__Proteobacteria;c__Betaproteobacteria;o__Methylophilales;f__Methylophilaceae;g__
testkevinmerged664	k__Bacteria;p__Proteobacteria;c__Betaproteobacteria;o__Methylophilales;f__Methylophilaceae;g__Methylotenera
testkevinmerged665	k__Bacteria;p__Proteobacteria;c__Betaproteobacteria;o__Neisseriales;f__Neisseriaceae;Other
testkevinmerged666	k__Bacteria;p__Proteobacteria;c__Betaproteobacteria;o__Neisseriales;f__Neisseriaceae;g__
testkevinmerged667	k__Bacteria;p__Proteobacteria;c__Betaproteobacteria;o__Neisseriales;f__Neisseriaceae;g__Eikenella
testkevinmerged668	k__Bacteria;p__Proteobacteria;c__Betaproteobacteria;o__Rhodocyclales;f__Rhodocyclaceae;g__
testkevinmerged669	k__Bacteria;p__Proteobacteria;c__Betaproteobacteria;o__Rhodocyclales;f__Rhodocyclaceae;g__Propionivibrio
testkevinmerged670	k__Bacteria;p__Proteobacteria;c__Deltaproteobacteria;Other;Other;Other
testkevinmerged671	k__Bacteria;p__Proteobacteria;c__Deltaproteobacteria;o__;f__;g__
testkevinmerged672	k__Bacteria;p__Proteobacteria;c__Deltaproteobacteria;o__Desulfobacterales;f__Desulfobulbaceae;g__
testkevinmerged673	k__Bacteria;p__Proteobacteria;c__Deltaproteobacteria;o__Desulfovibrionales;f__Desulfovibrionaceae;Other
testkevinmerged674	k__Bacteria;p__Proteobacteria;c__Deltaproteobacteria;o__Desulfovibrionales;f__Desulfovibrionaceae;g__Bilophila
testkevinmerged675	k__Bacteria;p__Proteobacteria;c__Deltaproteobacteria;o__Desulfovibrionales;f__Desulfovibrionaceae;g__Desulfovibrio
testkevinmerged676	k__Bacteria;p__Proteobacteria;c__Deltaproteobacteria;o__Desulfovibrionales;f__Desulfovibrionaceae;g__Lawsonia
testkevinmerged677	k__Bacteria;p__Proteobacteria;c__Deltaproteobacteria;o__Myxococcales;Other;Other
testkevinmerged678	k__Bacteria;p__Proteobacteria;c__Deltaproteobacteria;o__Myxococcales;f__;g__
testkevinmerged679	k__Bacteria;p__Proteobacteria;c__Deltaproteobacteria;o__Myxococcales;f__Haliangiaceae;g__
testkevinmerged680	k__Bacteria;p__Proteobacteria;c__Deltaproteobacteria;o__PB19;f__;g__
testkevinmerged681	k__Bacteria;p__Proteobacteria;c__Deltaproteobacteria;o__Syntrophobacterales;f__Syntrophobacteraceae;g__Syntrophobacter
testkevinmerged682	k__Bacteria;p__Proteobacteria;c__Deltaproteobacteria;o__Thermodesulfobacteriales;f__;g__
testkevinmerged683	k__Bacteria;p__Proteobacteria;c__Epsilonproteobacteria;o__Campylobacterales;f__Campylobacteraceae;g__Campylobacter
testkevinmerged684	k__Bacteria;p__Proteobacteria;c__Gammaproteobacteria;Other;Other;Other
testkevinmerged685	k__Bacteria;p__Proteobacteria;c__Gammaproteobacteria;o__Aeromonadales;f__Aeromonadaceae;g__
testkevinmerged686	k__Bacteria;p__Proteobacteria;c__Gammaproteobacteria;o__Alteromonadales;Other;Other
testkevinmerged687	k__Bacteria;p__Proteobacteria;c__Gammaproteobacteria;o__Alteromonadales;f__Alteromonadaceae;Other
testkevinmerged688	k__Bacteria;p__Proteobacteria;c__Gammaproteobacteria;o__Alteromonadales;f__Alteromonadaceae;g__Glaciecola
testkevinmerged689	k__Bacteria;p__Proteobacteria;c__Gammaproteobacteria;o__Cardiobacteriales;f__Cardiobacteriaceae;g__Cardiobacterium
testkevinmerged690	k__Bacteria;p__Proteobacteria;c__Gammaproteobacteria;o__Enterobacteriales;f__Enterobacteriaceae;Other
testkevinmerged691	k__Bacteria;p__Proteobacteria;c__Gammaproteobacteria;o__Enterobacteriales;f__Enterobacteriaceae;g__
testkevinmerged692	k__Bacteria;p__Proteobacteria;c__Gammaproteobacteria;o__Enterobacteriales;f__Enterobacteriaceae;g__Citrobacter
testkevinmerged693	k__Bacteria;p__Proteobacteria;c__Gammaproteobacteria;o__Enterobacteriales;f__Enterobacteriaceae;g__Enterobacter
testkevinmerged694	k__Bacteria;p__Proteobacteria;c__Gammaproteobacteria;o__Enterobacteriales;f__Enterobacteriaceae;g__Gluconacetobacter
testkevinmerged695	k__Bacteria;p__Proteobacteria;c__Gammaproteobacteria;o__Enterobacteriales;f__Enterobacteriaceae;g__Morganella
testkevinmerged696	k__Bacteria;p__Proteobacteria;c__Gammaproteobacteria;o__Enterobacteriales;f__Enterobacteriaceae;g__Proteus
testkevinmerged697	k__Bacteria;p__Proteobacteria;c__Gammaproteobacteria;o__Enterobacteriales;f__Enterobacteriaceae;g__Providencia
testkevinmerged698	k__Bacteria;p__Proteobacteria;c__Gammaproteobacteria;o__Enterobacteriales;f__Enterobacteriaceae;g__Serratia
testkevinmerged699	k__Bacteria;p__Proteobacteria;c__Gammaproteobacteria;o__Legionellales;f__Coxiellaceae;g__
testkevinmerged700	k__Bacteria;p__Proteobacteria;c__Gammaproteobacteria;o__Legionellales;f__Francisellaceae;g__
testkevinmerged701	k__Bacteria;p__Proteobacteria;c__Gammaproteobacteria;o__Oceanospirillales;f__Oceanospirillaceae;g__Marinobacterium
testkevinmerged702	k__Bacteria;p__Proteobacteria;c__Gammaproteobacteria;o__Pasteurellales;f__Pasteurellaceae;Other
testkevinmerged703	k__Bacteria;p__Proteobacteria;c__Gammaproteobacteria;o__Pasteurellales;f__Pasteurellaceae;g__Actinobacillus
testkevinmerged704	k__Bacteria;p__Proteobacteria;c__Gammaproteobacteria;o__Pasteurellales;f__Pasteurellaceae;g__Aggregatibacter
testkevinmerged705	k__Bacteria;p__Proteobacteria;c__Gammaproteobacteria;o__Pasteurellales;f__Pasteurellaceae;g__Haemophilus
testkevinmerged706	k__Bacteria;p__Proteobacteria;c__Gammaproteobacteria;o__Pasteurellales;f__Pasteurellaceae;g__Pasteurella
testkevinmerged707	k__Bacteria;p__Proteobacteria;c__Gammaproteobacteria;o__Pseudomonadales;Other;Other
testkevinmerged708	k__Bacteria;p__Proteobacteria;c__Gammaproteobacteria;o__Pseudomonadales;f__Moraxellaceae;Other
testkevinmerged709	k__Bacteria;p__Proteobacteria;c__Gammaproteobacteria;o__Pseudomonadales;f__Moraxellaceae;g__
testkevinmerged710	k__Bacteria;p__Proteobacteria;c__Gammaproteobacteria;o__Pseudomonadales;f__Moraxellaceae;g__Acinetobacter
testkevinmerged711	k__Bacteria;p__Proteobacteria;c__Gammaproteobacteria;o__Pseudomonadales;f__Moraxellaceae;g__Perlucidibaca
testkevinmerged712	k__Bacteria;p__Proteobacteria;c__Gammaproteobacteria;o__Pseudomonadales;f__Moraxellaceae;g__Psychrobacter
testkevinmerged713	k__Bacteria;p__Proteobacteria;c__Gammaproteobacteria;o__Pseudomonadales;f__Pseudomonadaceae;Other
testkevinmerged714	k__Bacteria;p__Proteobacteria;c__Gammaproteobacteria;o__Pseudomonadales;f__Pseudomonadaceae;g__Pseudomonas
testkevinmerged715	k__Bacteria;p__Proteobacteria;c__Gammaproteobacteria;o__Thiotrichales;f__Piscirickettsiaceae;g__
testkevinmerged716	k__Bacteria;p__Proteobacteria;c__Gammaproteobacteria;o__Vibrionales;f__Pseudoalteromonadaceae;g__
testkevinmerged717	k__Bacteria;p__Proteobacteria;c__Gammaproteobacteria;o__Vibrionales;f__Pseudoalteromonadaceae;g__Pseudoalteromonas
testkevinmerged718	k__Bacteria;p__Proteobacteria;c__Gammaproteobacteria;o__Vibrionales;f__Vibrionaceae;Other
testkevinmerged719	k__Bacteria;p__Proteobacteria;c__Gammaproteobacteria;o__Xanthomonadales;f__Sinobacteraceae;g__
testkevinmerged720	k__Bacteria;p__Proteobacteria;c__Gammaproteobacteria;o__Xanthomonadales;f__Xanthomonadaceae;g__
testkevinmerged721	k__Bacteria;p__SAR406;c__AB16;o__;f__;g__
testkevinmerged722	k__Bacteria;p__SAR406;c__AB16;o__SSW63Au;f__SHAS460;g__
testkevinmerged723	k__Bacteria;p__SR1;c__;o__;f__;g__
testkevinmerged724	k__Bacteria;p__Synergistetes;c__Synergistia;o__Synergistales;f__Dethiosulfovibrionaceae;g__Pyramidobacter
testkevinmerged725	k__Bacteria;p__Synergistetes;c__Synergistia;o__Synergistales;f__Dethiosulfovibrionaceae;g__TG5
testkevinmerged726	k__Bacteria;p__TM7;c__TM7-3;o__;f__;g__
testkevinmerged727	k__Bacteria;p__TM7;c__TM7-3;o__CW040;f__;g__
testkevinmerged728	k__Bacteria;p__TM7;c__TM7-3;o__CW040;f__F16;g__
testkevinmerged729	k__Bacteria;p__Tenericutes;c__Mollicutes;o__RF39;f__;g__
testkevinmerged730	k__Bacteria;p__Tenericutes;c__RF3;o__ML615J-28;f__;g__
testkevinmerged731	k__Bacteria;p__Verrucomicrobia;Other;Other;Other;Other
testkevinmerged732	k__Bacteria;p__Verrucomicrobia;c__Opitutae;o__Puniceicoccales;f__Puniceicoccaceae;g__Puniceicoccus
testkevinmerged733	k__Bacteria;p__Verrucomicrobia;c__Opitutae;o__[Cerasicoccales];f__[Cerasicoccaceae];g__
testkevinmerged734	k__Bacteria;p__Verrucomicrobia;c__Verrucomicrobiae;o__Verrucomicrobiales;f__Verrucomicrobiaceae;Other
testkevinmerged735	k__Bacteria;p__Verrucomicrobia;c__Verrucomicrobiae;o__Verrucomicrobiales;f__Verrucomicrobiaceae;g__Akkermansia
testkevinmerged736	k__Bacteria;p__WS3;c__PRR-12;o__Sediment-1;f__;g__
testkevinmerged737	k__Bacteria;p__[Thermi];c__Deinococci;o__Deinococcales;f__Deinococcaceae;g__Deinococcus
